?o-?EEM-B--To|--MM--EMo--?BBEX?--?-oE|-EoX--M-?|-T-?-o|MBMMEB-E--BBM?-M---E-M-ET-Xo------T----E----XXE--------?--M--T--X-|Xo---EBEMM---oo-Mo-|EEME-o?M----X---o?--EEB-EBET-BX--E?-o-E--X--MMo-B--oE-?-BB
T---|-?XM-?-----oo--ET-------T-B-?MoTM|----o---E----EB----Bo--|-?---|-E|-BBT?-?--M-?|T-X-B----T---T?E--|-TB-X?X---?--Mo--B-E|----o-XX?-XE-----E?|X-TTXX--oB-B-o-T|BB-M|BXMEB-B----o-M--oTME--B--?TE----o
M-?T-B-X----B-|-o-M---oE--M--X--B--M--B?------B-ooBX-X--T-oB|----?X------MBX----M-|--EoX----T--MX------T?BX|--oBE--Eo-MXB-X-----?EM--|-M-BM--|--oM----BE-------?---B----oXTXB--M--|--?|MT-oE-EB--|T--M-?
-?E-o-?---------X--MTE--X--X---X--?-----MX-?-?-----|MoM-BMo|X--|T-ET-|T|-?M|-?-----oXoBX-M----|X-B-E?|-?o--B--X--?---------M-TB-X-------o?-ET--T-X--o---|-XX-T-|B--M---E---MT-o--E-XE?----o-M-?o--MM----
M--T--o-XooEM|Boo-B-oXEo--B---X----?T--------M-M-o-XX-BM----X-----------o--o-TT--|--B-T-o-TX?E||-EEEE?-o-----MX---XXM----BB--B----ME-|oo--B--|MT?-T-|-BBT|o?--X-E--|T--B|Eo-TX-oBE--E-?--T-o--oM--T-EB-X
T-o------T--?o|T--E-XE---X--o-|-EX--?o--|--o--BX----MBBTToo|---X-E-?B-oT-X?----TT------X--B-||---B------T--o-T?--|-X-X-----T----?---M-M-?M?E----MEo-?----|----T-XBE-T-T-E------E---X---MBE-?B-B-EX-XM-TX
oEoEoM---|-?-?--BM--o----X---?--TX-X---B--B---?---BM|-E--To-?B----X---M-M-o--X-X-M--XB|-XBo-T-?--TE-E---MB-M--|--X|----BTT---?T--T|?T-T-----?------E-M?T-|B-X|oBo|TTE---oEM----B----M--MTX--?-B-o|-----|
XB----o-B----B?X-?o-T--oB----T|E||?-?-E--T-X?----||-?---MM----E-------X---X----oB-o-------X-BB-EEXT--oT-EBX-M-?-o--E--EEEo-EEBT|To-T--|o-M|XBE-E|-o|E-TB-B-BMBEE-o-B-?-----MT---X-o?-|--|--|M--M---E---v
o-|M?-?-B------E---B?o--|--E-B---o-B--XTMB------T-Mo-o-?|?-----XEE?E----|?-|-ME--?TXX?---Mo-T|o-B-|--oo--T--M-?--T-E|-M--?-XB-------|--E---M?|-M--oX-oT--|---ME--oBT--o-|E?--T----?------To?-X---M-T--BE
M|-X------?---|T-?-M--|-Xo?--XoTMTo--XT---XET-Bo--Mo-?-----T------?----X--T-E-M--?T|--E------?-|BTME-ME|X-T--MB--BTT-o-?-MBo-M----?----B-oTBBT?B-------M-Eo-X---?-BMM-|-EXB--B--TM--?E--TB|||-BoT||--||?
o-X--B-?-?o----X--M-B---|---X----Mo----?oBXX-?|--Xo--?|--M|----|-|Eo---|T--T--o?--|X-----M--BX-M---|T|M---------B?oEBM-T-T?E---oB-X-|--TBE------E-?X---|-E-|B-oM|----||---X-B-BX--Xo|--EoM-X-E------X-|E
B-o-|-M-|o-B--|||XEM---M|T----oM-TB-o--B|-X----T|T-E-------o-M---EM--M--MB|--E-|T-o---E-?-M?|B----?----|-T-M-XM-T--T-------X---------MM|TE----?X------Eo-X---o|----M-B-XE-M-?To--TM-X-T---oT-?---?XE---B
|M---?-T-B--?--E-oX-BT?-E-o|-oM-XE----BT-M-E?E--XoB----T-o--E---|?----?-------E?--M-?|Bo-------X-M-EE-------E--o--M-E-|-T---X|-X-TB--X-----oBB-B?-o---?B-M---B|-?-o--E--?-B---|o|?oM---MB-B-|-TTBBT-|o|X
?---BME-E?TX--T---|?-E---M---?-B---M-o||XB--B----EM-B---------|?X--BE--X-oM-B-o-X-BT-?----M----o-E-?-?--TX--oo---T-|---||--X?-|-TB-B?---|--E-M--|?XM?B--X-------X---B-?M-T---?---M--?-E-o-TM------T-MB-M
m--XB---------|-E-----M-?|--T|--?X----|E-|E----|-oB--|M-EE----?M--T-E-TMEME-TM--T|----o----|E|T?-Moo|??-?o----EBX--?|o?ET--?X--X--B-XM---To-E--E|BX-T?-?|M-E?--E?M---EX-o--B-?ME------|MMoE|TEMBo---o-BE
XXXXXXXXXXXXXXXXXXXXXXXXXXXXXXXXXXXXXXXXXXXXXXXXXXXXXXXXXXXXXXXXXXXXXXXXXXXXXXXXXXXXXXXXXXXXXXXXXXXXXXXXXXXXXXXXXXXXXXXXXXXXXXXXXXXXXXXXXXXXXXXXXXXXXXXXXXXXXXXXXXXXXXXXXXXXXXXXXXXXXXXXXXXXXXXXXXXXXXXX
