-------------------------------------------------------------------------------------XXXX--------------------------------------B-?-MBBBBBB?BB-----------------------------------------------------------
---------------------------------------------------------------------------------------------------------------B-------M-------B------B----------------------------------------oBBBB-----------o--------
-----------------------------------------------------------------------------------o--o----------------------?o?-----------?--------M------------------------------XXXXXXXXXXXXXXXXXX---------?----M----
--------M--------------------------------------------------------------------------------------------T--------XX-T---------X-----M-XXXXXX--------------------------X-------------------------T----XXXXX-
-----------------------------------------------------------------------------------------------------|M---T-BBX--|---------------X-?-TX-X---T----X------------------------------T---BBB????-X|----BB-X--
-----T---------------------------------------------------------------X-----------o-------------T-----|----|--XX--|-BB-----XXXXXXXXT--|T--X--|-X-XXX-----------------------------|----------XX|T-----XXX-
-----|---------------------------------------------------o-----------XX----X-------------------|--X--|-To-|?XXX--|-----XX-XXXX-XXX|XX||XXX--|TXXXXX-----------------------------|---------XTX||--XoXXXX-
-----|X-------X------------------------------------------X-----X-----XXX---XX------XB------X---|B---o|-|--|XXXXT-|---oXXX-XXXXXXXX|-X||XXX--||XXXXX---------------------T-------|--------XX|X||X-XXXXXXv
-----|--------XX-----------------------------------------------XX----XXXX--XXX----TXX-----XX--X|X----|B|--|XXXX|B|o-TXXXXoXXXXXXTX|XX||XXXX-||XXXXX---------------------|-------|-------XXX|X||XXXXXXXXf
-----|--------XXX----------------------------------------------XXX---XXXXX-XXXX---|XXX---XXX-XX|XXT--|-|-X|XXXX|-|--|XXXX-XXXXXX|X|XX||XXXXX||XXXXX---------------------|-------|------XXXX|X||XXXXXXXXf
-----|--------XXXX------o--------------------------------------XXXX--XXXXXXXXXXX--|XXXX-XXXXXXX|XX|T-|-|XX|XXXX|X|-X|XXTXTXTXXXX|X|XX||XXXXX||XXXXXXX-------------------|-------|--T--XXXXX|X||XXXXXXXXf
-----|--------XXXXX--------------------------------------------XXXXX-XXXXXXXXXXXX-|XXXXXXXXXXXX|XX||-|T|XX|XXXX|X|XX|XX|X|X|XTXX|X|XX||XXXXX||XXXXXXX-------------------|-BBB---|--|-XXXXXX|X||XXXXXXXXf
-----|--------XXXXXX-------------------------------------------XXXXXXXXXXXXXXXXXXX|TXXXXXXXXXXX|XX||X|||XX|XXXX|X|XX|XX|X|X|T|XX|X|XX||XXXXX||XXXXXXXX------------------|-----BB|BB|XXXXXTX|X||XXXXXXXXf
-----|--------XXXXXXX------------------------------------------XXXXXXXXXXTXXXXXXXX||XXXXXXXXXXX|XX||X|||XX|XXXX|X|XX|XX|X|X|||XX|X|XX||XXTXX||XXXXXXXXX-----------------|-------|--|XXXXX|X|X||XXXXXXXXf
m----|--------XXXXXXXX-----------------------------------------XXXXXXXXXX|XXXXXXXX||XXXXXXXXXXX|XX||X|||XX|XXXX|X|XX|XX|X|X|||XX|X|XX||XX|XX||XXXXXXXXXX------------E---|-------|EX|XXXXX|X|X||XXXXXXXXX
XXXXX|XXXXXXXXXXXXXXXXXXXXXXXXXXXXXXXXXXXXXXXXXXXXXX-XXXXXX---XXXXXXXXXXX|XXXXXXXX||XXXXXXXXXXX|XX||X|||XX|XXXX|X|XX|XX|X|X|||XX|X|XX||XX|XX||XXXXXXXXXXXXXXXXXXXXXXXXXX|XXXXXXX|XX|XXXXX|X|X||XXXXXXXXX
