-----------------------------------------------------------------------------------------------------------------------------------------B?---XXXXXXB------------------------??---------------------o---
-----------------------------------------------------------------------------------------------------------------------------------------------????????--BB---B----------------oBBBB-----------o--------
-------------------------------------------------------------------------------------------------------------------------------------------------------------------BXXXXXXXXXXXXXXXXX---------?----M----
--------M------------------------------------------------------------------------------------------------------------------------------------------BBBBBB----------X-----------------------X-T----XXXXX-
----------------------------------------------------------------------------------------------------------------------------------------X---T--T----o-o-X-XBXXXMX-Xo???T?X??BBBXTT--BBB?B??-X|XXXXBB-X--
-----T---------------------------------------------------------------X----------------------------------------------------------------------|-X|T???---X------X--XX--XX|XX-?-?XX||---------XX|T---X-XXX-
-----|---------------------------------------------------o-----------XX---------------------------------------------------------------------|TX||---XBTXX---BXXXXXX--XX|XX-?-XXX||---X--X-XTX||--XXXXXX-
-----|X-------X------------------------------------------X-----X-----XXX-----------X--------------------------------------------------------||T||-X-XX|XXT-XXXXXXXX-XXX|TX--XXXX||X--XXXXXX|X||X-XXTXXXv
-----|--------XX-----------------------------------------------XX----XXXX----------XX---------------------------------------------------M---|||||TXXXT|TX|XXXXXXXXXXXXX||X-XXXXX||XX-XXXXXX|X||XXXX|XXXf
-----|--------XXX----------------------------------------------XXX---XXXXX---------XXX------------------------------------------------------||||||XXX|||X|XXXXXXXXXXXXX||XXXXXXX||XXXXXXXXX|X||XXXX|XXXf
-----|--------XXXX------o--------------------------------------XXXX--XXXXXX---B----XXXX-----------------------------------------------------||||||XXX|||X|XXXXXXXXTXXXX||XXXXXXX||XTXXXXXXX|X||XXXX|XXXf
-----|--------XXXXX--------------------------------------------XXXXX-XXXXXXX-------XXXXX-----------------------------------------------o----||||||XXX|||X|XXXXXXXX|XXXX||XXXXXXX||X|XXXXXXX|X||XXXX|XXXf
-----|--------XXXXXX-------------------------------------------XXXXXXXXXXXXXX------XXXXXX---------------------------------------------------||||||XXX|||X|XXXXXXXX|XXXX||XXXTXTX||X|XXXXXTX|X||XXXX|XXXf
-----|--------XXXXXXX------------------------------------------XXXXXXXXXXTXXXX-----XXXXXXX-----------------------------------------------T--||||||XXX|||X|XXXXXXXX|XXXX||XXX|X|X||X|XXXXX|X|T||XXXX|XXXf
m----|--------XXXXXXXX-----------------------------------------XXXXXXXXXX|XXXXX----XXXXXXXX---------------------------------------------E|EX||||||XXX|||X|XXXXXXXX|XXXX||XXX|X|X||X|XXXXX|X||||XXXX|XXXX
XXXXX|XXXXXXXXXXXXXXXXXXXXXXXXXXXXXXXXXXXXXXXXXXXXXX-XXXXXX---XXXXXXXXXXX|XXXXXXX--XXXXXXXXXXXXXXXXXXXXXXXXXXXXXXXXXXXXXXXXXXXXXXXXXXXXXX|XX||||||XXX|||X|XXXXXXXX|XXXX||XXX|X|X||X|XXXXX|X||||XXXX|XXXX
