--------------------------------------------------------------------------------------------------------------------------------------------------------------------------------------------------------
------------------------------------------------------------------------------------------------------------------------------------------------------------------------------------------------BBBBBBB-
-----------------------------------------------------o-----------------------------o--------------------------------------------------------------------------------------------------------------------
----------------------------------------------------------------------------------------------------------------------------------------------------------------------------------???-------B-----------
-----------------------------------------------------------------------------------------------------------------------X-------------------------------------------------------------????--XXXXX-----B--
-------o--------------------------------------------------------------------------------------------------------------XX--------------------------------------------------------------------B------M----
---------------------------------------------------------------------------------------------------------------------XXX-----------------------------------------------------------------------------XX-
--------------------------------------------------------------------------------------------------------X----X------XXXX------------------------------------------------------XXXXXXXX--------------XXXv
-------------------------------------------------------------------------------------------------------XX---XX--B--XXXXX----------------------------------------------------------------------X----XXXXf
------------------------------------------------X---------------------M-------------------------------XXX--XXX----XXXXXX--------------------------------------------------------------XXXXXXXXX---XXXXXf
-----------------------------------------------XX-----------------------X----------------------------XXXX-XXXX---XXXXXXX--------------------------------------------------------------------XXX--XXXXXXf
----------------------------------------------XXX-------?-------------------------------------------XXXXXXXXXX--XXXXXXXX-----------------------------------------------------------------B-XXXX-XXXXXXXf
---------------------------------------------XXXX---------------------------------T-----------T--?TXTXXXXXXXXX-XXTXXXXXXX------------------------------------------------------T---T-----TXXXXXTXTTXTTXf
--------------------------------------------XXXXX---------------------------------|-----------|---|X|XXXXXXXXXXXX|XXXXXX-------------------------------------------------------|---|-----|XXXXX|X||X||Xf
m------------------------------------------XXXXXX------------------X------------E-|-----------|--X|X|XXXXXXXXXXXX|XXXXXX-------------------------------------------------------|-E-|----X|XXXXX|X||X||XX
XXXX----------XXXXXXXXXXXXXXXXXXXXXXXXXXXXXXXXXXXXXXXXXX-----XXXXXXXXXXXXXXXXXXXXX|XXXXXXXXXXX|-XX|X|XXXXXXXXXXXX|XXXXXXXXXXXXXXXXXXXXXXXXXXXXXXXXXXXXXXXXXXXXXXXXXXXXXXXXXXXXX|XXX|-M-XX|XXXXX|X||X||XX
