-T-o?-?------B---EE-|---T-o-B-|-|M-|X-MM-E--X--?B-----MT--M?-TXBXM--X---o-EB-|T|-M-BM|----|-M--?B|----B-T-oo-BBEX---?--o-----ETM-|T--M--|oE-M-----X|--E--??-TT|-E--M?-XX-BT---B-M-X-TXB---EMME-EX----X?-
-BM-B|-M-oMoB-ME|-o---EBET-oM-ET-T?T?-M--M-----TX--X----M|-BMEM---XTT---|BT---MT----To|--?---?--TM----oTM---|o-|T--B---M--X-XT--TXo------E-B---M-o-?-T-o-T--M--|||-M--?-M--E---X|--X?|B-XE--T-oXXB---?--
---E--M-B-M-------MXB-------B-E---|-o-BX-To-|-T-B|B-o--B?EEB----EM--M-B-ToTX--?T-T-----|T-------B|------BM-M-----Bo?BT---?--B?XE?o-|--X--M---|--BX-----o-----M--X------X-X|o-MB-Mo-MTTB--o-T-----Bo--B--
--T-o|---------TB-B-?-T-oT-oE?E--?T?-----B--BE---?o-M---|B-M-X---|-?-|----T|Mo---M--XB--------M-M-o-BE---B?TM-E--?---ET|----EMM------B--o--M-B|---BT-??|?-|-?-----BE?--B-B--oT-----MT|-oBM-----EX-----o-
-|---M---T---BMo----X--M--o--?-B-----MoM-M---E----?---T-TET-oT|X-T---X--|--XoE-T--BT-|-----oT-E---?--oEM--Xo--M----oE-|TX-|E--o--?XoT---B|-|-M--?-|EEXToE-XT-T---E----Eo---BM?o-X----T-X-oM--|B?-M----T-
-o|--T--E---XB--B|-?o-------?-XoM-X?---ET---E--T-|---o?o-----o-M--??-X-|---B-B-------X---BBT--?Eo---|-T--Xo?|X-X-BB-----o?M--B|M------X--?X--XM---?--|?-oE-|-?--B---|X-----X---XX-TETT-oB?o--ET|-XEX-XE-
-----------o-|X------o---------oB--ME-BET--|o|---ETT|--Mo-MB-T---T--------?-?--T|--M-----MM---o--X---E-B----E-E--E|T-T--o--|?T---X-----T--M-oMo-BB---|-M-B|B--o----T--TT--EB||X-----XXo---?-?|-EM--B?|--
--?-TB?-MM--o--MX-EX-TM-T|-?----ooTBX-X-XMT-BTM--M--o--X?|------E?--TET|T-o--TEM---EBo----|E?--o--|-|M?--TM-ET-o---B-E--M---o--MT----M-?--?----?--?ET--E---o--XBB-o-o?--MEo-o-T--E?---M-X--B-M-BM-?-?--v
---X-BME-TTMM--oo-?|-E-XB--M--oo-XMME-|-?--?-M-T---Mo--MM--M-MXXM-?--------|-?T-o?B--X---B--T-|--------M----BTT|------?EE---|M-B|-B--|--BBo-E-|o-T---B--M-X----?E---?oo-TTT---M-B---M|-----E-?-o-T-XE--f
-X--?M----XB-|-ET-TET?--?T-M-oTM|---T------X?-X--X|-M?M?M-T-XB----?o--E-------T-T--oM|E-M-Bo-X---XX-T??-M|--?-----E-??--BM--?-X--B--T-o-----E-?----M-X-o--T----o?-----EToMX-?--B--M-B-?-XBB-?M-MT?EE-B-f
--o--B?-oT|-----BXT??-T?|EB-T--ME----B|?--o-BT-ET||BB-o--MB--?o--B-|M-----E-T-E---TB-|-B-?o--|----XTX-?---M-M?-?--|--X-ET-----E--oB--TMM?|M-||BM------X--E-T--Too??-Mo-T-------XB--X-------T---ME--XM--f
--T-X----?T----MX--T--X-BTM--------??X----o|XBo--X--------EM-o?XX?--o?MEXX-BE-o--?----E-X-E|---Bo?-|-o-T--|-o-o----B?-o--?|B-|-ETo-o-T|----?------|To--|?-|----------ME-?-----?-|TX--E-B--E---Eo-?-?-MBf
-B-----o---E-----E-o------M--o-?ooE??Mo---oE?E|-B?-o--o--T---?------M--M---o-B-X-??M----|-EX--oM?-EE------BooX----B--o-M--|o|--TT--------Eo--M-?-o----T-BoB-B--M-|T-T|B---XMo--B--E-X-B|?---E--Xo?--XX-f
-----BE---??--X-----|BB---oE----M-E-T---T---M-oo-TE--|TB---X|-X-|-X|-----o---EX|M--T----T--o-MEM--?o-B-?-E--E|--M--M---o-B--|-M---E-o|T-B--?--oo--o-?|?Xo----B--X-MTXB----B-M|---B---XTM-X-|--?---T-T--f
mMEX-|-Mo|------|MT---|o-XM-M-B-MBB-----|---|X-|?|-M-BEBBM--XT?----MXE-E-X--X----|T---|E--o----B---Bo-E---M--T-XXB--?---ME---X-o------TX|XME-M---M---?--------?M-|?X--M-o----?----o-?|--oX---B---B--MT|X
XXXXXXXXXXXXXXXXXXXXXXXXXXXXXXXXXXXXXXXXXXXXXXXXXXXXXXXXXXXXXXXXXXXXXXXXXXXXXXXXXXXXXXXXXXXXXXXXXXXXXXXXXXXXXXXXXXXXXXXXXXXXXXXXXXXXXXXXXXXXXXXXXXXXXXXXXXXXXXXXXXXXXXXXXXXXXXXXXXXXXXXXXXXXXXXXXXXXXXXX
