------------------------------------------------------------X-----------------------------------------M-------------------------------------------------------------------------------------------------
----------------------------------------------------------------------------------------------------------------------------------------------------------------o---------------------------------------
-----------------------------------------------------o-----------------------------o-------------------------------------------------------------------------------------o------BBBXBBBB----?-----------
--------------------------------------------------------------------------------------------------------------------B-----------------------------------------------------------------------B-----------
--------------------------------------------------------------------------------------------------------------------------------------------------------------------X--------o-----------------------B--
-o-----o-------------------------------------------------------------------------------------------B---------------------------------------------------------------XX-----------------------B------M----
---------------------------------------------------------------------------------------------------------X--------------------------------------------------------XXX---MBoBXBBBB-------------X-------X-
--------------------------------------------------------------------------------------------------------X----X---------------------------------------------------XXXX------XX-XXXXXXXX-------XX-------Xv
-------------------------------------------------------------------------------------------------------XX---XX--------------------------------------------------XXXXX-----XXX---------------XXX-------Xf
------------------------------------------------X-----------------------------------------------------XXX--XXX-----------------X-------------------------------XXXXXX----XXXX---------XXXXXXXXX-------Xf
-----------------------------------------------XX-----------------------X----------------------------XXXX-XXXX----------------XX------------------------------XXXXXXX---XXXXX-------------XXXXX-------Xf
----------------------------------------------XXX-------?-------------------------------------------XXXXXXXXXX---------------XXX-----------------------------XXXXXXXX--XXXXXX------------XXXXXX-------Xf
---------------------------------------------XXXX---------------------------------T---T------TT--TTXTXXXXXXXXX--------------XXXX----------------------------TXXXTXXXX-XTXXXXX------T----XTXXXXX--T-TTTXf
--------------------------------------------XXXXX---------------------------------|---|-----?||--||X|XXXXXXXXX-------------XXXXX----------------------X----X|XXX|XXXXXX|XXXXX------|---XX|XXXXX--|-|||Xf
m------------------------------------------XXXXXX-------------------------------E-|---|------||--||X|XXXXXXXXX------------XXXXXX---------------------XXM--XX|XXX|XXXXXX|XXXXXEX--E-|--XXX|XXXXX--|-|||XX
XXXX----------XXXXXXXXXXXXXXXXXXXXXXXXXXXXXXXXXXXXXXXXXX-----XXXXXXXXXXXXXXXXXXXXX|XXX|-XXXXX||-X||X|XXXXXXXXXXXXXXXXXXXXXXXXXXXXXXXXXXXXXXXXXXXXXXXXXXXXXXX|XXX|XXXXXX|XXXXXXXXXoX|-XXXX|XXXXX-X|X|||XX
