-------------------------------------------------------------------------------------XXXX--------------------------------------B-?-MBBBBBB?BB-XXXXXX----------------------------------------------------
---------------------------------------------------------------------------------------------------------------B-------M-------B------B--------????????------------------------oBBBB-----------o--------
-----------------------------------------------------------------------------------o--o----------------------?o?-----------?--------M------------------------------XXXXXXXXXX-----------------?----M----
--------M--------------------------------------------------------------------------------------------T--------XX-T---------X-----M-BBBBBB----------BBBBBB----------X-----------------------XXT-------X--
-----------------------------------------------------------------------------------------------------|M---T-BBX--|---------------X-?-TX-X---T--T-X--o-------------------------------BBB-----X|-------X--
-----T---------------------------------------------------------------X-----------o-------------T-----|----|--XX--|-BB-----XXXXXXXXT--|T--X--|-X|TXX?---------------------------------------XX|T-----XXX-
-----|---------------------------------------------------o-----------XX----X-------------------|--X--|-To-|?XXX--|-----XX-XXXX-XXX|XX||XXX--|TX||XX-X-------------------------------------XTX||--XoXXXX-
-----|X-------X------------------------------------------X-----X-----XXX---XX------XB------X---|B---o|-|--|XXXXT-|---oXXX-XXXXXXXX|-X||XXX--||T||XX-XX------------------T----------------XX|X||X-XXXXXXv
-----|--------XX-----------------------------------------------XX----XXXX--XXX----TXX-----XX--X|X----|B|--|XXXX|B|o-TXXXXoXXXXXXTX|XX||XXXX-|||||TXXXTX-----------------|---------------XXX|X||XXXXXXXXf
-----|--------XXX----------------------------------------------XXX---XXXXX-XXXX---|XXX---XXX-XX|XXT--|-|-X|XXXX|-|--|XXXX-XXXXXX|X|XX||XXXXX||||||XXX|XX----------------|--------------XXXX|X||XXXXXXXXf
-----|--------XXXX------o--------------------------------------XXXX--XXXXXXXXXXX--|XXXX-XXXXXXX|XX|T-|-|XX|XXXX|X|-X|XXTXTXTXXXX|X|XX||XXXXX||||||XXX|XXX---------------|----------T--XXXXX|X||XXXXXXXXf
-----|--------XXXXX--------------------------------------------XXXXX-XXXXXXXXXXXX-|XXXXXXXXXXXX|XX||-|T|XX|XXXX|X|XX|XX|X|X|XTXX|X|XX||XXXXX||||||XXX|XXXX--------------|-BBB------|-XXXXXX|X||XXXXXXXXf
-----|--------XXXXXX-------------------------------------------XXXXXXXXXXXXXXXXXXX|TXXXXXXXXXXX|XX||X|||XX|XXXX|X|XX|XX|X|X|T|XX|X|XX||XXXXX||||||XXX|XXXXX-------------|-----BBBBB|XXXXXTX|X||XXXXXXXXf
-----|--------XXXXXXX------------------------------------------XXXXXXXXXXTXXXXXXXX||XXXXXXXXXXX|XX||X|||XX|XXXX|X|XX|XX|X|X|||XX|X|XX||XXTXX||||||XXX|XXXXXX------------|----------|XXXXX|X|X||XXXXXXXXf
m----|--------XXXXXXXX-----------------------------------------XXXXXXXXXX|XXXXXXXX||XXXXXXXXXXX|XX||X|||XX|XXXX|X|XX|XX|X|X|||XX|X|XX||XX|XX||||||XXX|XXXXXXX-------E---|--------EX|XXXXX|X|X||XXXXXXXXX
XXXXX|XXXXXXXXXXXXXXXXXXXXXXXXXXXXXXXXXXXXXXXXXXXXXX-XXXXXX---XXXXXXXXXXX|XXXXXXXX||XXXXXXXXXXX|XX||X|||XX|XXXX|X|XX|XX|X|X|||XX|X|XX||XX|XX||||||XXX|XXXXXXXXXXXXXXXXXX|XXXXXXXXXX|XXXXX|X|X||XXXXXXXXX
