---MB-----?|------------M----o----|-|--EE----------------------M--o---------o?-------E----B------BM---E----------oT---|M--X-||ME---------E---------T-oET----T-------M------|M-------T----T-------B------
------BX-X--X---X----X---------E?--------o----M--B-------X--M--E-o-X-------o----------T--------M-|-o?-o---o---|oE-E--X---E-B---X|-B----X?-----B|-?---M----B?--M--------o-----E-?---?-------E-B-E--|-B?--
----E-T--B-----|-----------|-E--E---------o---------M-?o--o--X-----------o---Bo---|T--X---B--------------o-----M---T------------------o------X-----------o-XX---X--?---M-------------------|--X|--XE----
-----B----T------T-X--------X-|?---------------M---M------|---|E-?----T-To-B---?---T-----?--o-----oT--o|--M------E--B-E-----------T--oEX----------?E----M---B---E--M--E---T-----XEMM-----|-|------|-----
-o-X-----------|------X--X-------------------ME------|------o----o------|---Mo-------E--M--X----B-----------?----E-----------TE--|-----ET-----oT-o-------Xo-|-E----BX---BM--------?E------E---?X---o--M-
---B-B|-o--o---------X-o-|--B-----X------------T-B------E---?M------M------|-o----E-----?-----T-----?----o----X--Bo----o-?-TM----X-X--|--E-----o----EEM---?-----X|E-??-?-------T-M--BT---|--|---?-------
---T--|X------T---------ET-----E-o--|--B--?-X-?------B?--T--B---o-----------|-------o?----M----MX--|?--------------X----EEMB----------o-TEo---------M-o?o-E---B----|--------oM|-T------?E-T-M----X----X-
----?------E---B--||-M?----T------E?-----|TT-XE-M?-BE---?--E------------o--T-----E------o?--M|------B-oB--------BX?|----o-------------o--X?-M-----?-----------------o------B------BBEEX----X-----------v
---?-----E--?----T---------MM-T--o---ET---------o--------B-----X-----T--M----?-X-----o-?---?--E-------|-XE-----M-------E----B--|---E---|----o---T?-To---o---E-T-?------------E--?--B---X------|-T?---|-f
-----EXE?-------------T--M-----T---T--T-X-------------B---B--o---------o?----T-----X----------------o--?---------------M---------B-?M-E-X-||--T-----o--X|---------T-|ME-?---B-----oT----E-----|--TT----f
---E|----o-M---------oB---B----E-|--E|---M-------T---B?-T--?--Boo-----EB---|E-M-EMX----?TE------X--XTXT----X-T--o?M-BE-----T----?--|o---|-o------?----Xo---Xo-|X-------M--|--E-|B?--?--|-TT--?-----T---f
-----------------T---B---o-o----Eo-------E------X--X|--o---|M-B--------X-|--MB-o--------o-T------------?------o--T-MM---E-------T----------X?---EX----o--B-X-|-----E-B-M-----?---|M-E-E----XB-X--------f
------o------M---E|-T?--M-|-|---------E------B-BT--|-|-o------oM--X---X--|------E|------E-M-X-|--B--?---|M--M-E-T?-|-Xo?--BM----X----X-----M--------o-B------M----?|------oB----?-oX----o------X-------f
----?-X--B--||------M-|M--o-M?----------?-----X-B-M------B|?---o-B--MMB-Eo--|B--E---X-X---TX-B---M--?--M?-E-B--|--------o-----?-M---------X-X------------------T--|--T-----XT------?-----o---X---XT---of
m-----M----M-|-T--BX------o--E-T-----Mo----X--M-TE--------T---------MEo----------|---X------M------T--X----BEo---?-------E-----T--o-Xo-E---?X------------o-----E-----TE-------MX--T-E------||?------T--X
XXXXXXXXXXXXXXXXXXXXXXXXXXXXXXXXXXXXXXXXXXXXXXXXXXXXXXXXXXXXXXXXXXXXXXXXXXXXXXXXXXXXXXXXXXXXXXXXXXXXXXXXoXXXXXXXXXXXXXXXXXXXXXXXXXXXXXXXXXEXXXXXXX-XXXXXXXXXXXXXXXXXXXXXXXXXXXXXXXXXXXXXXXX-XXXXXXXXXXXX
