----B---|oB-oM------------E-----?|--X-ME-?-----X-------|B-M---------------o-o---T----------------Xo-----BE---------T---------------?--o----o|-----MX|T?------oMM-------|---------E--|-X---------T----M--
-----B-oT----?----------B-?----------E------------o|-B--T-----T-M-----XMM?-------X-----o-----T---------------T-MB---T-------E----|---o-----?--|-M----T-----B---BX--MB-------B-E------M--B------------|--
-E---?-----o--X---------B---M---T---E--o--oo---?---|-X--X--E-----|T-------E--------?E-----|---MM-------EX----T--T--E------T-----To------?-----B-----T---X?---M-----X-----?------------|--XB?T-oT--------
--EE---M----?-o----EM----|-B-M--?|M-----XE-M---------------X--o--M-----X?B-----B-X--------|??-B----E-----|--------------E|------o-M------BEMB----o--------E-BE-?-EM---?-----M---X---?------?------------
---X---M----X------T--TB------------X---X-BoX--X?--X---|TE----------X-------------------B---------oM-o-B---?----------E--E-----ET------T------M--X--------??-----M--|--X-|--B---?--------X---M----M-T---
--B---E|---o--------?--E----?-----------?------------------------------------o--o-------B---|TBM-|----BX----|--|-T---M--------MBo--------?-M|-----X--X------------o---X---B-o-----B----------X---M---o--
-------X--?M-----------M----M---T---E?-T----------------------E-E---B?---------------o--------X-------X-E|--------T------M---M--?--E----X|-----------?-------------E--------o--M----B-|----M-?-|----T---
-----------EMM?-----?----------------B-----X----X--|---M-----------B--|---E---X---------?----E-o----XE?----|------B------M-----EX-X?M-----E--M--------X-------BToT----------o-------|B-?----o-----XBB--v
-X-----E--E---T--T-----|------X--?B-T-----E--o------X--E-o---M------?-M---?--T-X-EX--|--?B--?-X-BB--o------|-------E------------------E-MM----To----B-M?------XT----M--|-TE-----?--E------B-X--||---T--f
----------------|----XT--T----X----E-o---|M--M-?-o--oTM------T----BBB------B--?--T--M------|---o---TB-----|-------X--TTE--o--?--T?---oX-M?-E--------XE|-----X----E-|---o----E------------E----?T-------f
--|---B--|-o---o-----X------T-------|---?----B-o--M---------M?-----------??E-|EoE------oX-|------------T---X--XT-------------X|-X----o---M---M-----|E---------|----o--o-T-----|--X-E---------T-----M---f
---oo-T--M--------o---------o------M----|--M-----?---M|---?---------o---|---EM---E--X-B----------------------o-------E--------?------------|E-T--------|X--B-----------------------E-----?-B---o-------f
---------MXT-----------|-B------?-M-X---B-----------M---B-----------------E---------M--|-----------------------M-------X|--------M---B-----?-------EX---X-o-------T--B------X----------------XX|---X---f
-B----M-----B---o--M--------------XB----|-T----X-----|-oB---BXE---------------?---------M-----?oo--X-B--------o----X--To--M----X-M------?-M---------X-----------?-T----X-E-----------?---E-------ETE---f
m-----ME-------------oBM|---o------X?---------EB-----?-----TE----|---o--------------BM--------B--MM-|--?--------?-------oT-|----?-T--M-----------?---E-----X-|--------?--E?------M---------M--------|--X
XXXXXXXXXXXXXXXXXXXXXXXXXXXXXXXXXXXXXXXXXXXXXXXXXXXXXXXXXXXXXXXXXXXXXXXXXXXXXXXXXXXXXXXXXXXXXXXXXXXXXXXXXXXXXXXXXXXXXXXXXXXXXXXXXXXXXXXXXXXXXXXXXXXXXXXXXXXXXXXXXXXXXXXXXXXXXXXXXXXXXXXXXXXXXXXXXXXXXXXX
