----------------------T------T|-----B---------?--|-E------?------T----?----X---BX-----------o----M----|-T--X-------------E------|B---T--X|M-|?--|-o---?---T--o--M-----------B-------|M-----------|------
--|--------?---------M--------?----X-B------B---E------X?-----------E--X----?-----o---------------M------?--MB---X-|---M------E-----X-o|---T--X------------------o---------------------------T-------|--
----------------|X-----T------BM--o-B-------------E?E-T--X--------?-XB---BM-------------?----X-T--M----T---------X---------B---------oM-|-MMo?--B-------TX------M-X-|E------MM---EEM-E-E--T-T-EE?-------
-------|-------------X-----T--------MM----TE-------oE-----------E---|---------X-X----X-E---B---T------X-X---X|-------T??----T-BEB--?-XM----T---M---------MEB--E-----?-------o---?-------B-X----?-----B--
--|-----T-|--------Mo------|T----|o---o---------------M---T------o---?M-|----B---?-ET---|--|--Mo?-----?-X------M-X-XM-E-------------------------B--X----------oo---T---E-------------X-T--B--o|--M----o-
-------X|--M-----------B-X----E-----B-M-?---T--X?-------M---------X-----T|M--?---o---------|-B-----E------E---o?------E-o---|--E--|?--------M-------|-o-|---|-----E-----B-X-MT-------T----X-?E??----M---
---------o--B-|-------E?-----B-----E--E---------|-------B---?----B--B----------T----------?o---TM---E-BMX--o-?---|---------T-------?---E--E------MM-?|------|--E----M------------M---------X|T-?--------
------o---o--M--XEo-|------X----X|X--M--o---|B--------------oMEB-----------o-o|---o-----------------?---M--------X|-T--|---E------|B-B|---X---|--M------?---------?-----E--E--X---X----B----------MEo--v
--------|---|--?-Eo-T----E--T--------X--------o------|--------|-------|-------o-----B--X----?-----|o---o--E-----E--B--?|EoE--------o---MM----M--------|----T|-------------B-T--M----|--B--M-E---------Mf
--X------o--E---?--|E-------B---TTMX---------T----E|E|B-M--EM---------------X----?---o-------?X-----E----------Eo------X?T--T----o-----B-------------M-E|------M-|?-B----------o---E---E-------|-------f
--------------E--------------T-----B-MB---E--E-o--|-----|---|----oo-?---|---o-----M----o--o---oE-----oo?--|--T---B---B--BX-T------------------?|-M--------M--T-B---------------------------E-?-----T---f
------------|--M-------|-----------------B--B-BM---Bo--T-o-B|---B-o-----|o?-----M||--------M----|--o----X----X---To---oX--|--------M--?-X--------M--E----E-BMT---?----M-------B--M---T-M---E-----------f
--o-?-?--X|-?-------?-B-----------BB-----B-o--TX--|--M---|----M|T---TTo--------?------oo-----T-------o--o|TT---|---T-------oo----o--X--|?-----------|M--B-------M-------------T----------------?-------f
-----?--|-------oE------T|o----T----------XX-------M----------o-X-------T----B--|--------T---T-----M-M----E----E---X----------------T-----B----|-M----X---M--------?---------T?--TM-----------o-B------f
m---T----o---T-----T-||---|----------|-----MM---------------M--E---------ToBT---------------------oo----------------o--------------B-------?--X--XB--B------------BEB------E??----E-?----X-|-|T-o--M---X
XXXXXXXXXXXXXXXXXXXXXXXXXXXXXXXXXXXXXXXXXXXXXXXXXXXXXXXXXXXXXXXXXXXXXXXXXXXXXXXXXXXXXXXXXXXXXXXXXXXXXXXXXXXXXXXXXXXXXXXXXXXXXXXXXXXXXXXXXXXXXXXXXXXXXXXXXXXXXXXXXXXXXXXXXXXXXXXXXXXXXXXXXXXXXXXXXXXXXXXX
