------------------------------------------------------TT------------------------------------------------------------------------------------------------------------------------------------------------
--------------------------------------------|-------------------------------------------------------------------------------E--------E------------------------------------------------------------------
--------------------------o------E------------------------------E-------------------------E------------------------------------------E-------------------------X---------------------o--------------o---
------------------------------------------------------------o-|-------o--T---------|------X---------------------T--------|-------------------------------------------E-----o----------------------------
------------------------------X-----------------------------------------------------------------------------------------------|------------|-------|----------------------------------------------------
----------------------------------------------------------------------------------------------------------------------------------------------------------------------------E---------------------------
--------------------------------------------------------------------------------------------------------------------------------------------------------------------------------------------------------
---------------------------------o----------------------------------------T-----------------------------------------------------------------------------------E-------T----------|---------------------v
---------------o---------------------------------o--------------------------------------------------|------------------|------------------------------------T---------|----o---------------------------f
----------------------------------------------------------X--E--------------------T---------------------------------T----------------------------------------------------------------------------------f
--E--------------------------|--------------------------------------------------o---|-------------T----------------------E------------------------------------------------------------X----------------f
---T----------------------------|-------------------------------------------|-----------o------E----------------------------T---------------------X--------------------------------------------------T-f
--------------------------------------------------------------|-----------------------------------------------------------------E--------------X-------X--------------------------E-----------------E--f
-----|------------T---------------------------------T------------------------------------------------------------------------o----------------------------------------------o-|----------------T-------f
m------------------------------------------------------------------------------------------------------------------------------------------------------------------------------------------------------X
XXXXXXXXXXXXXXXXXXXXXXXXXXXXXXXXXXXXXXXXXXXXXXXXXXXXXXXXXXXXXXXXXXXXXXXXXXXXXXXXXXXXXXXXXXXXXXXXXXXXXXXXXXXXXXXXXXXXXXXXXXXXXXXXXXXXXXXXXXXXXXXXXXXXXXXXXXXXXXXXXXXXXXXXXXXXXXXXXXXXXXXXXXXXXXXXXXXXXXXX
