-o----------X-------------E---------------------------------------|-------------------------------------------------------------------------------------------------------------------------------------
------------------|-----------------------------------------------o--------X----------------------------------------------------------------------------------------------------------------------------
--o--------------------------------o----------------------------E-------------------------------------------------------T--------------------------------------X--------------------To------------------
-------------------------------------------------------------------------------------------------------------------------|--------------------------------------------------------------------T---------
-------------------oE----------------------------------------------------------------------------------------------------------------------|-------|----------------------------------------------------
-----------------------------------------o------------------------------------------------------------------X--------------------|-|----------------------------------T----------o----------------------
--------------------------------------------------------------------o----------------------------------------E--------------E--------------X---------------|--------------------------------------------
--------------------------------------------------------------------------------------------------------------------------------------------------------------E--------------------------------|-------v
-----------------------------------------------------------------T|-----------------------------------------------T----------X------------------X--E------X--------------------------------------------f
---------------------------------------------------------------------------------------------------------------------------------------------------------------|---------------------------------------f
--E----X-------E------------------------------------------------------E-T-----------------------------------------------------------------------------------------------E------------------------------f
----------------------------------------------------------------------------|--X--------o-------------------------------------------------X-------X----------------------------------------------------f
----X--------X----------------------------------------------------------------------------------------------------------------------------|-----o---------------------------------------------------E--f
---------------------------------------X----------------------X---------------------------------------------------------------------------------o----------------------E-------------------------------f
m------------------------------------------------------------------------------------------------------------------------------------------------------------------------------------------------------X
XXXXXXXXXXXXXXXXXXXXXXXXXXXXXXXXXXXXXXXXXXXXXXXXXXXXXXXXXXXXXXXXXXXXXXXXXXXXXXXXXXXXXXXXXXXXXXXXXXXXXXXXXXXXXXXXXXXXXXXXXXXXXXXXXXXXXXXXXXXXXXXXXXXXXXXXXXXXXXXXXXXXXXXXXXXXXXXXXXXXXXXXXXXXXXXXXXXXXXXX
