-o--M-------?-----B--------E--?|-----B?Eo|-------|-----M|M--?-------|--E-----------E-B-----X-----|-----T----Too-----M-?X---------------EM---B--------T--X--|------------B-E-X|--|M-|---|---|-?To-----M--
-|-X-T----------M??-|--B------M----------B----T-----B------------T-o-------T-o-----|-----------------------T-M-?-----oM-----X-----X---------------T---E---E---B-----E--X---Eo------|----?-?-o----B------
-?----?-o--E-----XX-----E----?----?----------T-oM----------o------?X-?----T--M-X?|-E----X---?--TX|--------X----------------X-------E--MBB------o-----M--|---o---X|---X-------o-------o-o------B--M----o-
-----To--------E-----------E------E---o---M---M-------o----E-----M-|---E--o-----TBTXT|---T----T-----ME--TE|----|-BBo?-----|MM---MM--ME-oE|---E-?-|TB-|--?-------TX-XT----B-?T--B---o---E--o-?--|--------
--X----?----B-----X----o---o----|o-|--?--------T-BB------T----------B---EE-B----|---BX--------o-?--------B-----XXB-----------M------?---------?--T?--MX---oBo--T-?---Bo-o-X----|------M---?--T----------
-B-----T---T----X-----B-------T-T------|B--E-----------o-oX---M---o--T------X---??TET------|---E-----B----Eo----------M--MB--M?-E---E-B----T---X---------TX--X-------?---oo--X---------------|o-----E---
---B-E-------o?o---X-o----E-------?---o---o---ooT----T----o---oX-M------M----E----B---o--|-X------------T--T----X-------?----?----------TT-|E--|----?T-----B------X------E?--X-o--B------|-M-?------X---
----------o--?----o----------------XM-------o--|o------|-T--T---X----?--E---X-----X|-------Eo-E--M---T---o--TB--X--XB-------M------?---o-----E--M---?-o-E----E--T----------o----E-----B------oE-Xo-----v
-M--E----?----M-----B-?-E--T-----o--T---|?---T--------X----EE--?---EXoT------------------X---X-------o-----|---------E--T-oM---To-----T-?-----M----?-----E-|To-----|-----T-------X-|----MM--M|-?XX--TT-f
----E------EX--oT----?----B---T--o---B---------E--|-|o---?|ooX---------TT--?-o----?-T-o----|----------o-----BT-----?T-------o---o?------X------------?-M---?-T--EM|-E---X--X-o------------------T----o-f
--------?T----XM-----------B------------B-----T--o--|--T--E----E-E--B--B-o-TMo--X----T--M-B--T-------E---X|-----T-----B-E------------o|??---T-XTM---E----|----?--o?--oM-o---B---ET---------T-?------B--f
--E--EE---------|X----E--T---------E--E-M---E-M-------|----E--|-------------XT--?-X----?--Mo-------E----M-----|-|--M----T---X-------?---XE--E-X--|---E---X-------|-----------|---------?-E??X----E----Ef
--?E-----E-E|-E----T---------T--ME--|X-----oX----B--M|--E-----M--T------B----E----X-----|X-TT--M---------?-B-Xo---M-----B-----------?--T---BB-----TTB--o--B----TEo?-X--M-M--?|TX------M-o-----X----T---f
-----M-----B---XE--TEX-|?T----M-----------------o-?---E----B---|E-----X---------TM---T--B---|---------?-T---XE--E---MBTo----?--X---------MB------T-----|-o----EEo-------E-M---------T-T----------T-----f
m-----XM-||M?-M--o?------TB---|------------------------M------?-----M----M-|--------|--------E-o-----X---?--------?--X-|-E-XT---o------T--T-E-o---------------------|-T-oT-M---o-B------?B------E-T----X
XXXXXXXXXXXXXXXXXXXXXXXXXXXXXXXXXXXXXXXXXXXXXXXXXXXXXXXXXXXXXXXXXXXXXXXXXXXXXXXXXXXXXXXXXXXXXXXXXXXXXXXXXXXXXXXXXXXXXXXXXXXXXXXXXXXXXXXXXXXXXXXXXXXXXXXXXXXXXXXXXXXXXXXXXXXXXXXXXXXXXXXXXXXXXXXXXXXXXXXX
