--------------------------------------------------------------------------XXXXXXX--X----M--????????-----B---------o-------M-X--------------------X-B----------------------------------------------------
--------------------------------------------------------------------o-------------------------?---------o----------?-B---------o-----o---BBBB-M---------------o-----X----XB--?--------------------X-----
--------------------------------------------------------o-----------o-----M--------------?-----------------------------------M----------------------------------------------------------?-------------B-
-----------------------------------------------------------------------o----------------------o-------o-------T--------------------MX------------------------------?---------T-XXXXXX---BBBBBBBB--------
-------------T---------------------------------T---------------------------T------------------------T------X--|---------X------------M-----?????X-------------------------X--|--?XXXXoXX--XTXXX---X-M---
-----o-------|---------------------------------|---------------------------|-------------------TXBT-|-----XX--|-----???XX???-B------------o----XX------------------------XX--|--T--------XX|oX-?-XXB-BT-
-------------|---------------------------------|---------------------------|-------------------|XX|o|----XXX--|-------XXX-M-B-T-----------o---XXX----X------------------XXX-T|--|X-X----XXX|XX--XXXo-X|-
-X-----------|---------------------------------|---------------------X-----|-o--------------BTB|XX|B|---XXXX--|------XTXX----o|M-T-T-X---X---XXXX---XX-----------------XXXX-||--|X-XT?-XXXX|XX-XXXX-XX|v
---X---------|---------------------------------|------?---X---------XX-----|------T--B------X|-|XX|X|--XXXXX--|-T---XX|XX-----|--|-|XX--XX--XXXXX--XXX---------T-----?XXXXX-||--|XXX|XXXXXX|XXXXTXXXXX|f
---XX--------|---------------------------------|----------XX-------XXX-----|?T????|--To----XX|-|TX|X|BXXXXXX--|-|XXXXX|XX--T-X|-X|-|XX-XXXXXXXXXX-XXXX---------|XT???XXXXXX-||--|XXX|XXXTXX|XXXX|XXXXX|f
---XXX-------|---------------------------------|----------XXX-----XXXX-----|-|--?-|--|-?T-XXX|-||X|X|TXXXXXX--|-|-XXXX|XXT-|--|XX|X|XXXXXXXXXXXXXXXXXX---X-----|X|BBXXXXXXX-||--|XXX|XXX|XX|XXXX|XXXXX|f
---XXXX------|---------------------------------|----------XXXX---XXXXX-----|-|--o-|--|-T|XXXX|-||X|X||XXXXTX--|-|XXXXX|XX|X|--|XX|X|XXXXXXXXXXXXXXXXXX--XX-----|X|XXXXXXXXX-||-M|XXX|XXX|XX|XXXX|XXXXX|f
---XXXXX-----|---------------------------------|---------MXXXXX-XXXXXX----X|-|----|X-|-||XXXX|-||X|X||XXXX|XX-|-|XXXXX|XX|X|--|XX|X|XXXXXXXXXXXXXXXXXX-XXX-----|X|XXXXXXXXX-||--|XXX|XXX|XX|XXXX|XXXXX|f
---XXXXXX----|---------------------------------|----------XXXXXXXXXXXX----X|-|----|XX|-||XXXX|-||X|X||XXXX|XXX|X|XXXXX|XX|X|X-|XX|T|XXXXXXXXXXXXXXXXXXXXXX-----|X|XXXXXXXTX-||X-|XXX|XXX|XX|XXXX|XXXXX|f
mE-XXXXXXX---|---------------------------------|----------XXXXXXXXXXXX----X|X|E--E|XX|X||XXXX|E||X|X||XXXX|XXX|X|XXXXX|XX|X|XX|XX|||XXXXXXXXXXXXXXXXXXXXXX-----|X|XXXXXXX|XX||--|XXX|XXX|XX|XXXX|XXXXX|X
XXXXXXXXXXXXX|XXXXXXXXXXXXXXXXXXXXXXXXXXXXXXXXX|XXXXXXXXXXXXXXXXXXXXXXXXXXX|X|----|XX|X||XXXX|-||X|X||XXXX|XXX|X|XXXXX|XX|X|XX|XX|||XXXXXXXXXXXXXXXXXXXXXX-XXXX|X|XXXXXXX|XX||-X|XXX|XXX|XX|XXXX|XXXXX|X
