--------------------------------------------------------------------------XXXXXXX--X----M--????????-----B---------o----------------------------------------------??----------X------------------o-------
--------------------------------------------------------------------o-------------------------?---------o----------?------------------------------------------oo----X----XB-o?--------------------X-----
--------------------------------------------------------o-----------o-----M---------------------------------------------------------------------------------------?????-----------------?-------------B-
-----------------------------------------------------------------------o----------------------o----------------------------------------------------------T---BTBBBB?B--------T-XXXXXX---BBBBBBBB--------
-------------T---------------------------------T---------------------------T------------------------T----------------------------------------------------|-o--|----XXXXXXXX--|--?XXXBoXo--XTXXX---X-M---
-----o-------|---------------------------------|---------------------------|-------------------TXBT-|----------------------------------------------------|----|----------XX--|--T--------XX|oX-X-XXB-XT-
-------------|---------------------------------|---------------------------|-------------------|XX|-|----------------------------------------------------|--??|??-------XXX-T|--|X-X----XXX|XXXXXXXoXX|-
-X-----------|---------------------------------|---------------------X-----|-o--------------BXB|XX|B|----------------------------------------------------|----|-----???XXXX-||--|X-XT?-XXXX|XXXXXXXXXX|v
---X---------|---------------------------------|------?---X---------XX-----|------T--B------XX-|XX|X|---------?-T----------------------------------------|--o-|T---o-?XXXXX-||--|XXX|XXXXXX|XXXXTXXXXX|f
---XX--------|---------------------------------|----------XX-------XXX-----|?T????|--Xo----XXX-|XX|X|-----------|XX--------------------------------------|-o--||XT???XXXXXX-||--|XXX|XXXTXX|XXXX|XXXXT|f
---XXX-------|---------------------------------|----------XXX-----XXXX-----|-|--?-|-----T-XXXX-|XX|X|TXXX-------|----o-----------------------------------|-BBB||X|BBXXXXXXXX||X-|XXX|XXX|XX|XXXX|XXXX||f
---XXXX------|---------------------------------|----------XXXX---XXXXX-----|-|--o-|-----|XXXXX-|XX|X||XB--T-----|------X--------------------------------M|--T-||X|XXXXXXXXXX||-M|XXX|XXX|XX|XXXX|XXXX||f
---XXXXX-----|---------------------------------|---------MXXXXX-XXXXXX-----|-|----|-----|XXXXX-|XX|X||XX--|-----|------XX-X------------------------------|--|X||X|XXXXXXXXXX||--|XXX|XXX|XX|XXXX|XXXX||f
---XXXXXX----|---------------------------------|----------XXXXXXXXXXXX-----|-|----|----X|XXXXX-|XX|X||XXX-|-----|------XXXX------------------------------|--|-||X|XXXXXTXTXX||X-|XXX|XXX|XX|XXXX|XXXX||f
mE-XXXXXXX---|---------------------------------|----------XXXXXXXXXXXX----?|-|E--E|--oXX|XXXXX-|XX|X||XXXX|?--E-|EE----XXXX-------------------------E----|--|-||X|XXXXX|X|XX||XX|XXX|XXX|XX|XXXX|XXXX||X
XXXXXXXXXXXXX|XXXXXXXXXXXXXXXXXXXXXXXXXXXXXXXXX|XXXXXXXXXXXXXXXXXXXXXXXXXXX|X|----|-XXXX|XXXXXX|XX|X||XXXX|?----|XXXXXXXXXXXXXXXXXXXXXXXXXXXXXXXXXXXXXX--|--|-||X|XXXXX|X|XX||XX|XXX|XXX|XX|XXXX|XXXX||X
