--------------------------------------------------------------------------------------------------------------------------------------------------------------------------------------------------------
------------------------------------------------------------------------------------------------------------------------------------------------------------------------------------------------BBBBBBB-
--------------------------------------------------------------------------------------------------------------------------------------------------------------------------------------------------------
----------------------------------------------------------------------------------------------------------------------------------------------------------------------------------???-------B-----------
-------------------------------------------------------------------------------------------------------------------------------------------------------------------------------------------XXXXX-----B--
--------------------------------------------------------------------------------------------------------------------------------------------------------------------------------------------B------M----
-----------------------------------------------------------------------------------------------------------------------------------------------------------------------------------------------------XX-
------------------------------------------------------------------------------------------------------------------------------------------------------------------------------XXXXXXXX--------------XXXv
----------------------------------------------------------------------------------------------------------------------------------------------------------------------------------------------X----XXXXf
--------------------------------------------------------------------------------------------------------------------------------------------------------------------------------------XXXXXXXXX---XXXXXf
--------------------------------------------------------------------------------------------------------------------------------------------------------------------------------------------XXX--XXXXXXf
-----------------------------------------------------------------------------------------------------------------------------------------------------------------------------------------B-XXXX-XXXXXXXf
-------------------------------------------------------------------------------------------------------------------------------------------------------------------------------T---T-----TXXXXXTXTTXTTXf
-------------------------------------------------------------------------------------------------------------------------------------------------------------------------------|---|-----|XXXXX|X||X||Xf
m------------------------------------------------------------------------------------------------------------------------------------------------------------------------------|-E-|----X|XXXXX|X||X||XX
XXXX---XXXXXXXXXXXXXXXXXXXXXXXXXXXXXXXXXXXXXXXXXXXXXXXXXXXXXXXXXXXXXXXXXXXXXXXXXXXXXXXXXXXXXXXXXXXXXXXXXXXXXXXXXXXXXXXXXXXXXXXXXXXXXXXXXXXXXXXXXXXXXXXXXXXXXXXXXXXXXXXXXXXXXXXX|XXX|-M-XX|XXXXX|X||X||XX
