--------------------------------------------------------------------------------------------------------------------------------------------------------------------------------------------------------
--------------------------------------------------------------------------------------------------------------------------------------------------------------------------------------------------------
--------------------------------------------------------------------------------------------------------------------------------------------------------------------------------------------------------
--------------------------------------------------------------------------------------------------------------------------------------------------------------------------------------------------------
--------------------------------------------------------------------------------------------------------------------------------------------------------------------------------------------------------
---------------------------------------------------------------------------------------------------------------------------------------------------------------------------------------------------????-
---X----------------------------------------------------------------------------------------------------------------------------------------------------------------------------------------------------
--MXX-----------------------------------------------------------------------------------------------------------------------------------------------------------------------------------o--------------v
---XXX----------------------------------------------------------------------------------------------------------------------------------------------------------------------------------B--------------f
---XXXX------------------------------------------------------------------------------------------------------------------------------------------------------------------------------------------------f
---XXXXX-----------------------------------------------------------------------------------------------------------------------------------------------------------------------------------------------f
---XXXXXX----------------------------------------------------------------------------------------------------------------------------------------------------------------------------------------------f
---XXXXXXX---------------------------------------------------------------------------------------------------------------------------------------------------------------------------------------------f
---XXXXXXXX--------------------------------------------------------------------------------------------------------------------------------------------------------------------------------------------f
m--XXXXXXXXX-------------------------------------------------------------------------------------------------------------------------------------------------------------------------------------------X
XXXXXXXXXXXXXXXXXXXXXXXXXXXXXXXXXXXXXXXXXXXXXXXXXXXXXXXXXXXXXXXXXXXXXXXXXXXXXXXXXXXXXXXXXXXXXXXXXXXXXXXXXXXXXXXXXXXXXXXXXXXXXXXXXXXXXXXXXXXXXXXXXXXXXXXXXXXXXXXXXXXXXXXXXXXXXXXXXXXXXXXXXXXXXXXXXXXXXXXX
