---------------------------------------------------------------------?--------------------------?????------------?XX---?--------------?------------XX-oXXXXXX-------------------------------------------
--------------------------------------------------------------------------------------------------------M------------------------------------o----------------------------------------------------------
------------------------------------------------------------------------------------------------------------------o-----------------------o---------BBB----------??????---------------------------------
--------------------------------------------------------------------------------------------------------------------------------------------------------------------------------------------------------
-------------------------------------------------------------------------------------------------------------X?---M-----------o-------------------------------X-------BBB--------X----------------------
---------------------------------------------------------o------------------------------------------o-X--B--XX----XB-X--B----Xo---X--------XXXX?XXXX--X------XX-----X--X--------XX---------X------------
-----------------------------------------------------------------------------------------------MX-----XX---XXXX??XX--X------XX---XX?-------XX------XXXX-----XXX----XX-XX-X-----XXX---------XX-----------
-----------------------------------------------------------------------------------------------------BXXX-XXXXXXXXX--XX--M-XXXX-XXXXB---X--XXX--X-BXXXXBBBBXXXX-XXXXXXXXXX----XXXX---------XXX---------v
------------------------------------------------------------------------------------------------------XXXXXXXXXXXXXXBXXXBBXXXXXXXXXXX---XX-XXXXXX?XXXXXoXXXXXXX-XXXXXXXXXX---XXXXX---------XXXX--------f
-------------------------------------------------------------------X----------------------------X-----XXXXXXXXXXXXXXXXXXXXXXXXXXXXXXXXX-XXXXXXXXXXXXXXXX-XXXXXX-XXXXXXXXXX--XXXXXX---------XXXXX-------f
------------------------------------------------------------------------X---------------X----B-----X--XXXXXXXXXXXXXXXXXXXXXXXXXXXXXXXXX-XXXXXXXXXXXXXXXXXXXXXXXXXXXXXXXXXX-XXXXXXX---------XXXXXX------f
--------X-----------------------------------------------------------------------XXXXXX--XX-------o-o--XXXXXXXXXXXXXXXXXXXXXXXXXXXXXXXXXXXXXXXXXXXXXXXXXXXXXXXXXXXXXXXXXXXXXXXXXXXX---------XXXXXXX-----f
------------------------------------------------------------------T------T------T----T--XXX--T------BXXXXXTXXXXTXXTTXTXXXTXXXTTXXXXXXTXXXXXXXXTXXXTTTXXXXXXXXXXXTTXXXTXTXXXXXXXXXX--T------XXXXXXXX----f
------------------------------------------------------------------|------|------|----|--XXXX-|------XXXXXX|XXXX|XX||X|XXX|XXX||XXXXXX|XXXXXXXX|XXX|||XXXXXXXXXXX||XXX|X|XXXXXXXXXX--|------XXXXXXXXX---f
m----o-E--------------------------------------X-------E-----------|--E---|??----|----|--XXXXX|-E---XXXXXXX|XXXX|XX||X|XXX|XXX||XXXXXX|XXXXXXXX|XXX|||XXXXXXXXXXX||XXX|X|XXXXXXXXXX--|------XXXXXXXXXX--X
XXX--------XXXXXXXXXXXXXXXXXXXXXXXXXXXXXXXXXXXXXXXXXXXXXXX-X---XXX|-----X|XXXXXX|XXX-|--XXXXX|----XXXXXXXX|XXXX|XX||X|XXX|XXX||XXXXXX|XXXXXXXX|XXX|||XXXXXXXXXXX||XXX|X|XXXXXXXXXXXX|XXXXXXXXXXXXXXXXXXX
