--------------------------------------------------------------------------------------------------------------------------------------------------------------------------------------------------------
--------------------??-----?????------------------------------------------------------------------------------------------------------------------------------------------------------------------------
-------XXX---B------------------------------------------------------------------------------------------------------------------------------------------------------------------------------------------
-----?------o-------------------------------------------------------------------------------------------------------------------------------------------------------------------------------------------
--------------------------------------------------------------------------------------------------------------------------------------------------------------------------------------------------------
-----------X-----------X--------------------------------------------------------------------------------------------------------------------------------------------------------------------------------
---X--X----XX---------XX--------------------------------------------------------------------------------------------------------------------------------------------------------------------------------
---XX-XX---XXX-------XXX-------------------------------------------------------------------------------------------------------------------------------------------------------------------------------v
---XXXXXX--XXXX-----XXXX-------------------------------------------------------------------------------------------------------------------------------------------------------------------------------f
---XXXXXXX-XXXXX---XXXXX-------------------------------------------------------------------------------------------------------------------------------------------------------------------------------f
---XXXXXXXXXXXXXX-XXXXXX----------------------------------------------------------------------------------------------------------------X--------------------------------X-----------------------------f
---XXXXXXXXXXXXXXXXXXXXX-------------------------------------------------------------------------------------------------------------------------------------------------------------------------------f
---XXTXXXXXTXXXXXXXXXXXX--------------------------------------------------------------------------------------------------------------------------------------------------------------------T----------f
---XX|XXXXX|XXXXXXXXXXXX--------------------------------------------------------------------------------------------------------------------------------------------------------------------|----------f
m--XX|XXXXX|XXXXXXXXXXXX--------------------------------------------------------------------------------------------------------------------------------------------------------------------|----------X
XXXXX|XXXXX|XXXXXXXXXXXXXXXXXXXXXXXXXXXXXXXXXXXXXXXXXXXXXXXXXXXXXXXXXXXXXXXXXXXXXXXXXXXXXXXXXXXXXXXXXXXXXXXXXXXXXXXXXXXXXXXXXXXXXXXXXXXXXXXXXXXXXXXXXXXXXXXXXXXXXXXXXXXXXXXXXXXXXXXXXXXXXXXX|XXXXXXXXXXX
