-XE-o-?---X?--T-|---Eo-o-|----EMX----MBXo-|-X--T-?X-oTTT-E-----T--BME--X--o?---X--B--MM----B?T-T-|M-EXB--M-E-T-MT-----?-?|--ooMMX-E??------E?--|--M-------o--M-ME|o---o|-o------T----TXo-----E|--ooT|-X-
----|----Mo-----M-o?-?-EX--o----o-?-TE-M----o---T--M--|-o-T--|BE----T?----To-B?--|Xo----E-M?B--E---E--oT---M----B-------M-XM-o-T----Bo---o-?--?--------?--o-M--|-----o-XE--X--X-B-oB--o----|XM?o-M---E--
-|-T----B-----T?---M-----EX-B--|X--------M?-?-T?--?--E-?-B-Bo-B----B--|--------E-X|oTXE---?---|XMo?-T-?-T-B-XT?-Bo?-B-BoM-E----?X----X-?--oo--|--B-?-?MMoBE|--T-M--o--|E?-|-----X-M----EB-B----B-E-T?E--
--E-------E--|M-o-|----o-----o-X---------?-TX---ToXT?|----TM-ME------E--oBB--?--M--BTX--E--|-T-|||?M-?-----XXE--|---oX|EM---T-----TX--?-MB--B----T-o-?o----X--BXX---B---B-?---M-------EB--X--XM-X--|----
--?E-----X---|---E-T---oMMX?oo--XE--TE--o-|??B-|---T-B-E--M-|--|?o--E--oTB??-TMB------|-TE-BEB-oB------X--E--E-----X?X-X-BTX?------MT-o?MoT-TB-M-T?------M---??-----E--T-TXo--X-----|-??-o?-|--T?-B-?-?-
-X--E?-XoTM-B?----o-XM----?M-T--XTo-oMT?--B|E----MX?B-?|-E-T---------|---o--T-?M----E----|-|--B----?-T----?|E----?-X-|-M-MBMBo?o---------MX-|-T-o--|--Eo--EX?---oXT?-X----B-T-Eo--?XBBT---MEMT--|--T-oB-
---oB|-B----oMM||---M-?M-T--E?--?B----|----T---|--M?----|--TX--E---M--XXo--TB?--X---E----?-EX--E-|----E--MM-----E-|?---Xo?B---M-----T--X--oB--|o-E--?M-|o-oTo?-o-|-B-E-o-|--E--??-?--B|----XT-|B-o-|--X-
--X-----MMM-?E------M--T--BM---B---EB?-----X?o---X--?TT--oM---?--BT--||-B-?-M-B--B|-M----E--TBXBE---E----o----MB---X-XBT|o--XB-o-T-E-XE------To-X---M-B?M?------E------o-----T|--T-TT-M|--M---ToET?oT--v
-|--E-B|-?--|----X-|-EBMXM-?--BE-|XM--|-XMBE----B-?------X?MMM--BTXT-o--X|BX----E-?-B-o-X-BB-X-EM?T-BX?o-X---oMTE--|XM----BME-o-o-X?------T-TE----|X---M---------?-o------X--?---M-M-|-M---M-TX-?-B--TMf
----|--E----TEME---E--TB-MTB--------||--B---E---E|---|-?-Eo-E-XoX----|----Bo--EX--E-Eo-B-E--M-E--oX--|XB-EX--E-E---EMEE--EB?BMo?-oB---X--E-B-o-o?---MM-----X-------|M-X|M|-X-M-ME|-BTX-?M-?--M-|---?o--f
---TX-oX-?oo--X---o-|M|----X--B?-----ET---|-BB|-B?-B-B----M---?B---XET----To-MXTEoX---?B----M-Eo--XB-EM?---?--?E-|--B-|XTTMTT-o-o----------EX?-oE-M--T-E---?-----T-o|TB?oMo?--M?---BE--M--oM----T-EoT--f
-o?oT---?----B-MMX?XX----o--X-|-XB------Xo--|o-X-B----T-TE--T---B------TTT-----?|----o--Eo-TM?--B?-B|---o-E--BE-MX--T-B|??E--X-X---M-----X|----X-----|----BX------o---?--T---|-----BMB-E--B--oMXET---BEf
--TEE----EM-oT-----BoM|?----B---B|o---|?TB--?---|-------?X--o--MM--M---Eo-Eoo|XToET-X--M----B-ooM--BX-o-EX-M-----M-?-E-|BETTTB--EM--T-B-|E-EM?|E---MoT-oX--?--BEX----BX--M-MXE---?-o-oM-X-T-XB-?-ETM-T-f
---E-oo-T----o-MM---B--X----T---EE-E|-------|----|--?---M---BXMX-o?-|B?-o-|MTM----EToE---XoB-?--MEo-B-ET-E-E-B-----B-M|--E?-XMETX----oXXX-o-------|-E--X?----?oM--M--E-o---o-o--||-X-o|XXM|---T--B|-M--f
m-XM-T--EX?T--o--B---?ME-|-M-X--?-----|--MM---?oBEX---|T|-----B-E|E-XE|----?---|--E--|-M?o-E-M---X--TBM--|-----MX--B--|--|---MB---B-TE---|--|B-BoT--ET----?-B----E---E-B--E--T--|-Mo---?T-Xo-|----M-?--X
XXXXXXXXXXXXXXXXXXXXXXXXXXXXXXXXXXXXXXXXXXXXXXXXXXXXXXXXXXXXXXXXXXXXXXXXXXXXXXXXXXXXXXXXXXXXXXXXXXXXXXXXXXXXXXXXXXXXXXXXXXXXXXXXXXXXXXXXXXXXXXXXXXXXXXXXXXXXXXXXXXXXXXXXXXXXXXXXXXXXXXXXXXXXXXXXXXXXXXXX
