-------------------------M------------------------------------BBBBBBBXXXXXBBBBBBB--------B---------------oo-------------o-----oo-----------------------------------------------------------o--o---------
----------------------------------o---------------------------------X---------M-X---------------------BX-------------------------------------------o-----------------------------------??????-----------
--------------------------------------------------------M-------------------X-----?----?------------X---o----X---------BBB----------BBBBB-----------X-------------Mo---------------------------XXXXXX-o-
----------o---------------------------------------------------------o---------------X----B-T----------T-----------M----------------------------------------------------o-----------T-----M---T-------T--
--------------------------------o------------------------------oM---------T----------?-----|-o--------|----o------???---M-X-X-----o-----------------M-------------------X---------T|------Xo-|---XXXX|--
----------------------------------------------T----------------------T--BB|B--------------T|-----XT---|-????????---X---T-XXXX-----------T----X-----------T-------?-----XX---------||X-o-----X|---BXXX|X-
----------------------------------------------|-----X----------------|---X|---------X-X---||-----X|---|-----BXBBBMXX-T-|XXXXX-o---------|---XX-----------|------------XXXB--------||X-------X|?------|X-
----------------------------------------------|-----XX-------------M-|--XX|--------XXXX-BB||B----X|X--|------XX--XXX-|-|XXXXX-------X---|--XXX----T------|-----------XXXX----T--T-||X--T---XX|X-----X|Xv
----------X----------------------------o------|-----XXX--------------|-XXX|-----?-XXXXX---||T----X|XX-|-----TXXXXXXXT|X|XXXXT--o---XX---|-XXXX---B|BBBBB-|----------XXXXX???X|XX|X||XX-|---XX|XX---XX|Xf
----------XX----------------------------------|-----XXXX-------------|XXXX|---X--XXXXXX---|||----X|XXX|T----|XXXXXXX||X|XXXX|-X---XXX---|XXXXX----|------|---------XXXXXX----|BB|X||X--|---XX|XXX-XXX|Xf
----------XXX----------------T-------X--------|-----XXXXX----XXXXXX--|XXXX|---XXXXXXXXX-B-|||Xo-XX|XXX||----|XXXXXXX||X|XXXX|XB--XXXX---|XXXXX-X--|------|-------BXXXXXTX----|?X|X||X--|X--TX|XXXXXXX|Xf
----------XXXX---------------|--T----XX-------|-----XXXXXX----------X|XXXX|---XXXXXXXXX-XX|||XXXTX|XXX||X--X|XXTXXXX||X|XXXT|XX-XXXXX--X|XXXXX----|---?--|-------XXXXXX|X----|XX|X||XT-|XX-|X|XXXXXXX|Xf
----------XXXXX--------------|BB|BBB-XXX------|--X-?XXXXXXX--------XX|XXXX|BB-XXXXXTXXX--X|||XXX|X|XXX||XXXX|XX|XXTT||X|XTX||XXXTXXXX-XX|XXXXX----|------|------XXXXXXX|X---?|XX|X||X|-|XXX|X|XXXXXXX|Tf
----------XXXXXX-------------|-T|o---XXXX--M--|XXXX-XXXXXXXX------XXX|XXXX|--XXXXTX|XXX-XX|||XXX|X|XXX||XXXX|XX|XX||||X|X|X||XXX|XXTXXXX|XXXXX----|---T--|-----XXXXXXXX|X---X|XX|X||X|B|XXX|X|XXXXXXX||f
m---------XXXXXXX--E----EE---|-||E---XXXXX-BE-|--XXXXXXXXXXXX----XXXX|XXXX|EXXXXX|X|XXXXXX|||XXX|X|XXX||XXXX|XX|XX||||X|X|X||XXX|XX|XXXX|XXXXX----|E--|E-|----XXXXXXXXX|X--XX|XX|X||X|-|XXX|X|XXXXXXX||X
XXXXXXXXXXXXXXXXXX--XBBXXXXXX|X||XXXXXXXXXXXXX|XXXXXXXXXXXXXXXX-XXXXX|XXXX|XXXXXX|X|XXXXXX|||XXX|X|XXX||XXXX|XX|XX||||X|X|X||XXX|XX|XXXX|XXXXXXXXX|XXX|X-|---XXXXXXXXXX|X-XXX|XX|X||X|X|XXX|X|XXXXXXX||X
