-o--E-E-E--o-?-E-----?|M---XEMB------BE--B--o-?-Eo--X-X-TT-oXo--?-XE|-Bo--BTM--??-T--X-T----o--o--BET|--|M----T--------MX-T-ET---B--|-----|T|---------M-B-T?|-B?X?TMXXT--M--EE-oo?B-?-TBBB------?--X-M--
------XT-??--B-?-|-------M---?--X-?Mo-----EEE-M-------M----T--TM-?-B-B----o-EX-XEE-o----E|-X---o-X?----?---ME-T-TMB--------B---|----o-B----|---?----?-MX----X--XEoX-TM--B-B---|-----T-MB-oME-TToM-??|X--
-?B-?--MEE--EToo-M--M---T-B-X--X----o------|---XE-B-?-X|-E----T|E---M--Mo----oTE-?---oB-|-----|-?T-EE--E-B--B|-o-|?XT-T-B--X-?-MMEM|T-TM-X-M-?E|--?--|-B-?X----MoTMoMB----MoT--XM--------------Bo|E-??--
---|M-X--|E|-|B|--MBEM-B-----B-|B-|----|T---o----?MooE-----M---E-E-----X----T-TM---M-------MEE----XTBEB--T---|----?--E--|M-T|-|-|?-----TT-To-----------oM-o-M-X----T---M-T---oM-X-?EXE----o??----T------
---oE-?ET--|-M-------?M-?-?M?X-?-E----TT-M?-?T|-o?X?M----||----?E-E-o-X-T-----BEM-E------?----?--?-?---oTB--o-TM|--E-T---?oM-B?-|--|-B|TM----||--T?--|E-|o-X|-----M----?--|??-----B---B-|??o------------
---|-----?----|E--X-------BB?M---TMMo---?-E-E------TEBME-X|X-TB--------?|-T?o----o|-BB-X|---?----|--T|-|-?--MB||----M----EM--EB----?|---E|---To-M-|-E--M----B-BMo----oB-BoX??X|--EB--BE-EB---E------o-B-
---?---o-?TBB-M---ooE----|T-----o--o--|E------T-E----MB|?--E--o---oM-X------|----TB-|-XB--BX----B--o--X---M|--T-|--o------?o----MM?--MM-------X--M-MTB?--M--?--BM------X-Bo----oB-XB-E-|-?--ET--?-|-TX--
--X-T-B--X-X-BX|---B-ETE-oo---X----XT---o---o---Eo---oM-TE---?B--|-B----o-------BT-BX--------T-X-X---|E---??X-?o-|B---|-TM-TXX-E--M--M-?E-E---M-M-|---X|-?--X-----X|------E--B-XTo--EMXToB-XoX---T-----v
-MB--TE--EX--X-X-?T?--B||---BT--o-ETE----?-------B|M-M-o-oo-E-B------|--T-|-B--M-o|-T--o-?T-T-?TE--TBXX-o---M-TT|X--E---T-----E--?|-TE-T--?-o-----?-----Mo?--|---B-|-?--XTo--?---B-T-?X---|EM--------?-f
-M------oB-TX|-E---MX-M-E-MooX--T-MX-|o-M-B--o-|M--T--?M-X----|E--MM--TT---o?--EBTB---MB-o--M-|B-EoE?----TT-----T-----?E---BB---To-----M--|ET-o-|o-X-?MTMT---|B-MXMXM-----M-TME-T----X-o?--B?-XTXo---E-f
-------|--?T------EE--??----|B-E|M-----X|M|?B--M-B-Mo--|--?MXT-X---|--o-----|--MXMo--?o-?------||-X-----|B|---??---X--?--o?--??ET-ET-M?-o----EEE---T--E----------T-T---?To--o|oX-----?|--?-----|?---oM-f
---XT--T--B-T|MT--E-TM----?-E-B---T-T--M--------BoTXM--M---MX--|----o-BB--BB-|T---XX----------o-----T--X-|E--|X-T--o-B---o-o-o|-XB--ME-oBBM--E-XoX-?-BTX-?--TTX-X-T-MMMT-E---XXXBMB--E--o|----|EET|?---f
-X----?o--BB--E-B|-T?-|-M--E-|--M--|X---o----M---XMB--M-o---------T----|--|--T??-o-|Bo?-XXB-B-------oT|----Mo?--o-E--E--?E--oX-?EoME-M-|--TB?M-X-EBX-B-----XoX-?-TXMo-M---E---E----o------E-----B-----Mf
---XT---B-?-T?E-M---o?-----o---o-X?-o--?--EX|o-Mo|----E-BX|BT--?|TB-Eo---E-B--M-MB-|----X---TB---M-o?--T--o-X----ET-B?M-Xo?TooM--?ME|--M----T-E--T-X-E-E-M--E-o-TMT|--X-----o||B?--X-?-|--E|Mo--T--?-B?f
mo---TX-EM?T?--o-|-----M-?-E-o-----EM---?--M-----|T-E-|X?M-o---To--??-?-|-E-T---o---E--B-oM-B-X--|oBo--?-MT--E----o-T-?T-?-XE---M-E|-X---EX-EE--X|-oBX-To-T?M-E-T-BMT-?--o?------??o-o?---Mo-MM---|--|-X
XXXXXXXXXXXXXXXXXXXXXXXXXXXXXXXXXXXXXXXXXXXXXXXXXXXXXXXXXXXXXXXXXXXXXXXXXXXXXXXXXXXXXXXXXXXXXXXXXXXXXXXXXXXXXXXXXXXXXXXXXXXXXXXXXXXXXXXXXXXXXXXXXXXXXXXXXXXXXXXXXXXXXXXXXXXXXXXXXXXXXXXXXXXXXXXXXXXXXXXX
