------M-----------o---------------?---------------B-------------------------------------------------?---------------------------------------------------------------------------------------------------
------------------------------------------------------o-------------------o-------o---------------------------------------------------------------------------------------------------------------------
-----------XBBBBXX----?------------------------------B-----------------------------M------M------------------o-----------------------------------------------------------------M---o--------------------
-------------------XX---------------------------o----------------------------------------M--------------------------------------------------------------------------------------------------------------
---------------------X-----BBBBBBBo-----------X-----------XXXXX---------------------------------------------------------------------------------------------------------o-------------------------------
---XBoB-X-?---------XX----------------X-------------------XX-------o-M---------o-o----------------------------------------------------------------------------------------------------------------------
---XX?--XXX----XB-BXXXBBo---BBBBB--X-XX--------M---------XXX-------Xo----MX--------------------------------------X--------------------------------------------------------------------------------------
---XXX--XXXX--XXBBXXXX?B-----------XXXX----------X-----XXXXX-------XX-----XX--?----------------------------------XX-M----------?-----------------------------------------------------------------------v
---XXXX?XXXXXXXX-XXXXX-----X-----X-XXXXX--------------XXXXXX-X-----XXX----XXX-XXXXXXXX-?--------X----------------XXX------X----------------------------------------------------------------------------f
---XXXXXXXXXXXXXXXXXXX-----XX----XXXXXXX-------------XXXXXXXBXXBBB-XXXX---XXXX-X---------X-----XX------XXXXX-----XXXX-----XX---------------------------------------------------------------------------f
---XXXXXXXXXXXXXXXXXXX---X-XXX---XXXXXXX------------XXXXXXXX-XXX---XXXXX--XXXXXXX--------XX---XXX----------------XXXXX----XXX----------BBBB---------X--------------------------------------------------f
---XXXXXXXXXXXXXXXXXXX-o-XXXXXX-XXXXXXXXX----------XXXXXXXXX-XXXX--XXXXXX-XXXXXXXX-------XXX-XXXX----------------XXXXXX---XXXX---------------B-----XX--------------------------------------------------f
---XTXXXXXXTXTXTXXXXXTT--XXXXTXXXXTXXXTXXX--------XXTXXXXXTX-TTXXX-XXTXXXXXXXXTTXXX-T-T--XTXXXXXX-----T------T---XXXXXXX--XXXXX-------------------XXX--------------------------------T-----------------f
---X|XXXXXX|X|X|XXXXX||XXXXXX|XXXX|XXX|XXXX---o--XXX|XXXXX|X-||XXXXXX|XXXXXXXX||XXXX|-|--X|XXXXXX-----|----o-|---XXXXXXXX-XXXXXX-----------------XXXX--------------------------------|------M----------f
m--X|XXXXXX|X|X|XXXXX||BEXXXX|XXXX|XXX|XXXXX----XXXX|XXXXX|X-||XXXXXX|XXXXXXXX||XXXX|E|X-X|XXXXXX-----|------|-E-XXXXXXXXXXXXXXXXE--------------XXXXX--------------------------------|----------E------X
XXXX|XXXXXX|X|X|XXXXX||--XXXX|XXXX|XXX|XXXXXX--XXXXX|XXXXX|X-||XXXXXX|XXXXXXXX||XXXX|X|XXX|XXXXXX-----|------|--XXXXXXXXXXXXXXXXXXXXXXXXXXXXXXXXXXXXXXXXXXXXXXXXXXXXXXXXXXXXXXXXXXXXX|XXXXXXBXXXXXXXXXXX
