-E-E-o|-T--XX-TT--BE-|-------M-M--T-EE--TB-?---TM-X-----o-------M-T|--o-E-|------B|?E--Xo--TB|-M--M-TBB--B--?--EMX|-M-B-X--XME--B-M---T-?-MM-|X--To--E?M|------oBM-o-----o?------o----E-BooE--??XoMB-?--
---EoX-ooM--XXXBE-E--E--M--B----|o---TEo-EB---EB------B--XM-|B-T--?MT|B-M?o------B-B|EB-B---XM?--|-T---o-----B?o---B-----X-M--o-M----|---o-?-MB|----XM-TE-oTo|-T---|-o-----o-X-X----E-|-?-E-?--oE-TE----
-----ET--E|?--T-ooMX-B?|-------TE|X?------E-|BB-X--?-o-|X-----B-||-TMo-BBTT|--o----E---E-X?---?-M--X?-M----TE-|T-BTX?-------E----B---T-?X?--T-E--|-??o|Eo--?X---M-B-ToMo--M-X-BB----------B-o-M-EoX-Mo?-
-|-o-T--TT----BE-|-?MM---o---EX-M--|E-ME------?||-?oE--B-----B--X-X|--|TX---B--X?---o?--XT-|MT-?--MX-M-M-----?XoT-X-------E--M-----o-X|---o|--M-M-TMX---X-T--?-----o-E-|------E-TBEoB?--T---BX?o?oT--B--
-?--|?-M--T--TEoE---X|-X-?--E--|E--oXMM-EMMXB-----MM-X-|B-B|--MM--EM-o?--E-X-----X---E--o-MB-B-o-?B--o---o-oX-MTT--T--TBX||------X--o-BoX|X--B-----o-M---X-EBB----E-----ET-------T-E--?---|E---XoX---Eo-
---T-----------M--TT?Eo-M-BB--M------?---EX--?-TX--|-o|M---|-?E|--E-B---o---E-ET?--BX-X-E--?---TB-T---XM-|--T--?-----ET----ooTo--M-TETM-M-o-?|--TT-oEM--MM-BT|o--B---|E---E-TM---X---TEEo-X?--?E|T?--oT-
-XB-BT|E-----ooXEM-----B---M-------Eo-M---X-------|X-TBT----BX-o-?B------X-T?--M?B-B?E?--T------Mo--X--o-ETX-|---EX-------MT-?-E-----o?E-XoM-E?-TBX--X--B-|oE--BT------Mo---MMX----MMB-TM--ME-EM--?o----
-T-E|M---oE--B-X--|---T---X-o---|----M--------BE---?--T-T---T--X-B--?X|-----Xo-------B------Eo--?X-B|M---|---XE-?--------?--?--E---T--|-B-XM|-o-oE----T-MEBEEB--o-X----?E-----B---E-?----?--E---B-E----v
-----BXEM---BT-TB-B-EX--E--M---T--T--XEM--T-oX?-ME-TBM---M--o-ME-MT-----|-|-B-?|-o-------E---T-E|BEX----oBE-|-o-BETXE|-BT----TE----T----EBX-T------E|-?---MXo---MoT|----T---?-B-||BoT-X-T?-?-----BoX---f
---?X--M-E-X|B?-TB-o-MEo--B-|----B-X-----M-----EB---B|---B-X---------------B-|-------EE---BM---|-B-E---M|TE--oBo---B|-E----BB-Bo---o---|-X?XX-T--?-?B?--?o---|--E-T---|MM-?M--E-----?--M-B--T?---?TMM-of
-----M---?T------|X---Eo?------|T--BE?--B-T-MBET-X-EE--TMMT-------E?------|-B-E---|TT---B--B------?E-|-o|M--T-XEX?EX-?-----o?E-----------|X-o-|T-B-----T-M----B-T?M-o---?--|-------Eo--T-E--M-o-E--|-|Ef
-E--?T-|---XB-T-M?---X------E--T?T-------o--?XE----TE||T--T-M?o-TME?|---o-ET-??X|?-B---T-TT---M----?-BM---|---E-o---MT-|B?E-MM--o-|---BM-X?--Xo?X-E-B?--E---E|-E-----?-M---Eo---?-BT---BB--B---MM|o-E-Bf
-T|E--T-T?TE-BBB--M?----X----B---M-E----|-T----|oo-M-------MTMXM--oB|T|-?-oXB?------?EBT-o-TM?-M---Boo------M-E-E-TXo--M--M|MBXE--T-?-?---T---To-BM--B--|----X----B--M-M--o--M-E-EM-E-B-E----M---T-E-MEf
-|-TX----T-?-o-o----M---XBXMo-?-B---B-MB----EM-----Eo--o---T--M---o-?o-o-MT-M|-X-B--TE|M-XEE--E--|o--X-Xo---o?--??-E----E--X--?---|-ETT-?|-----------X----XEEoo---B--E----------TT-T--?-X--?-o|--o-TT-of
m|T-M--M---B-?BM--X--M--E-----oT-?----B--|---BTo-??---?------|B-|M---B--T--o--oXEX--|--BX?---|-ME--------M--XX|oXo--EE-o-T--T|-E---M--M-?M|---?-X?--------EBT--T--EXM--E--B-?--To-M?T--E----MM----|-?-TX
XXXXXXXXXXXXXXXXXXXXXXXXXXXXXXXXXXXXXXXXXXXXXXXXXXXXXXXXXXXXXXXXXXXXXXXXXXXXXXXXXXXXXXXXXXXXXXXXXXXXXXXXXXXXXXXXXXXXXXXXXXXXXXXXXXXXXXXXXXXXXXXXXXXXXXXXXXXXXXXXXXXXXXXXXXXXXXXXXXXXXXXXXXXXXXXXXXXXXXXX
