--E---o-------M-----------M---E------E--T--------------X--X---E----T---B--ET-|T---E---M-------------------------?-o----T--|-----------|B--Mo-M-----M--------------X---M-To-TE|?-?-----E-----------oXE-|-
---|---|--T-----TT|---X----T-|---M--TX--?-----|--X---B----o--X--------o----o-----|--o-|B?----------------|----------?----E-X--X-XB||-M---|M--T-BM-|-?o--o--X|--------------------------------TB------|--
--------T---B-------XE--M|M--?-o-----o?E----B-------------T----|M-------BX---o-------o-----B-----?----|--------o----Mo---E---?M----B------------------T---------E?------T||-X----X--------E-|-?-----?|--
-----?M---------M|E---X-T--|X---XT---?|---------XE-------T|----------B-BB-|-B-|---------------------T---B----EE---X--|-|---T---X-E---?---X-o-T--------T---X--------o--------------EM-----E-B-o----M-oX--
------o--??B---T--------|B-T-B---?-------------?--------EoMo------B-|-----TE-------|-o--T-----------X---T-BE-TX-------X----------o--X--------o-o---B-----T---------B--|---EX----T------M?--M------E|----
-T--X--X-------B-----XT----BX----T------------------X--------------------T-EB--oXB-B-|--X-o-T----B----T---T----|---M------M-------oo------------o-E----X---E----B-----?---o-----?--B---------o--B--?--X-
--|E-|-?----TT-E---?-----B-M----------M----------X---X-oo-|---o?-|---------------------o---X-X--TM-----E-----------|-------T-----E-EoB------XXo-|M|-o---------T----EX-------------|--M---------B-|E-----
--o--B--?---oo------MB---?-o--E------|-----------------------------M----M----|--o-----o-?M---------B-----o------oT--o------E-----M-B-T-X---------------T-----EE-o-----------------|-B---o----oM-|T-B---v
---------|----?-----?---o|--M----------------|--|-----E--X--|-MEXX--------|---------o-----o------|---B-|E--|----M-----oo-BX--T--|--E---B---------------B--M||---------o-------oB------?------o---M--E--f
----|----TE--------MM--|---X---X--X-----------M-o------?------------?--E------?------------------T--------?-------o---------------M?---T-----X----?-o------MX-T--T----T---o?TB-B---M---X--------X--Eo--f
---------------X-B----MB----|E---?-X?-----|T----M--?-----------B-------o----TM--------?------B---M-------E-BM----------T----E---|-o|--|-o----------------B----------------B---T----X-------XT-E-|------f
-------------M----ET-T-----BMo-----T------o-?o-------o--|------?-----?-------BoM-----To--X------------------E---X----M-T--XX--B-?---XM-----------oXM---------o---------X-------X--Bo-o-X-------|----E--f
-----------E-B--?--T---------T---E--?-E--------------B-----|-T--M---------------E----o----o----T-B?--T---Bo------?---M----TM--BM---------?--------|-------o------?---|T---BT-X----------|-B----T-------f
------X----M----BB------M---B------M---B---E-E---EE-----M-XM---X------------o----?-E---B-E-MB-|-----B--------|-----E------------E----T--|--TEX--E?M--B--T--TB--E--|-------------TX?----X---T-------?---f
m|--T-E----MoT-M---T--BX-o----EB-?---------------M--X----M-----o--E---?------T-|-----X-M---------?-------oM--B?---?----o--?-----|T---M?-M--------------B---|-----------M--Eo--T---M-X--B---M----XBT-M--X
XXXXXXXXXXXXXXXXXXXXXXXXXXXXXXXXXXXXXXXXXXXXXXXXXXXXXXXXXXXXXXXXXXXXXXXXXXXXXXXXXXXXXXXXXXXXXXXXXXXXXXXXXXXXXXXXXXXXXXXXXXXXXXXXXXXXXXXXXXXXXXXXXXXXXXXXXXXXXXXXXXXXXXXXXXXXXXXXXXXXXXXXXXXXXXXXXXXXXXXX
