-M-------------------------------------------------------------------------------------------------------o----------------------------------------------------------------------------------------------
--------------------------------------------------------------------------------------------------------------------------------------------------------------------------------------------------------
---------X--------o-------------------------------------------------------------------------------------------------------------------------------------------------------------------------------------
------------XXXXXXX-------------------------------------------------------------------------------------------------------------------------------------------------------------------------------------
-------?--------B---------------------------------------------------------------------------------------------------------------------------------------------------------------------------------------
-----------X---------------------------------------------------o----------------------------------------------------------------------------------------------------------------------------------------
---X--X----XX--------------------------------------------------------------------------------------------X----------------------------------------------------------------------------------------------
-BBXXBXX---XXX-------------------------------------------------------------------------------------------XX----XXXXXX----M-----------------------------------------------------------------------------v
---XXXXXX--XXXX-------------------------------------------------------------------------?---------------XXXX------------------------------------------------o------------------------------------------f
---XXXXXXX-XXXXX---------------------------------------------------X-----------------------------------XXXXXX------------------X-----------------------------------------------------------------------f
---XXXXXXXXXXXXXX-----------------------------------------------M-------------------------------------XXXXXXXX--X-------------XX--------X---X----------------------------X-----------------------------f
---XXXXXXXXXXXXXXX------------------------------------------------------------------X----------------XXXXXXXXXX-XX????---?---XXX-----------------------------------------------------------------------f
---XXXXXXXXTXXXXXXX---------------------------------------------T------T------------XX--------------XXXXXXXXXTXXXXX---------XXXX---TT-------------------------------------------------------T----------f
---XXXXXXXX|XXXXXXXX--------------------------------------------|------|-----B------XXX------------XXXXXXXXXX|XXXXXX-------XXXXXo--||-------------------------------------------------------|----------f
m--XXXXXXXX|XXXXXXXXX-------------------------------------------|------|------------XXXX----------XXXXXXXXXXX|XXXXXXX-----XXXXXX---||-----------E-------------------------------------------|----------X
XXXXXXXXXXX|XXXXXXXXXXXXXXXXXXXXXXXXXXXXXXXXXXXXXXXXXXXXXXXXXXX-|-XXXXX|XXXX-------XXXXXXXXXXXXXXXXXXXXXXXXXX|XXXXXXXXXXXXXXXXXXXXX||XXXXXXXXXXXXXXXXXXXXXXXXXXXXXXXXXXXXXXXXXXXXXXXXXXXXXXX|XXXXXXXXXXX
