---------------------------------------------------------------B----------------------------------------M--M-------------------------------------------------X------------------------------------------
----------------------------------------------------------------------------------------------------------------------------------------------------------------X-----o-MBBBBM---------X------???????---
--------------------------------------------------------------------------------------------------------------------------------------------------------------------B----------BBBB--B-------oX--o-M----
-------------------------------------------------------------------------------o----------------------------------------------------------------------------------?X??????--------------------------oo--
--------------------------------------------------------------------------------------------------------X-----------------------------------------------------------????????X---------------------------
----------------------------------------------------------------------------------------X--------------XX-----X---------------------------------------------------X--------XX-X----X----BBBXXXXXX-XX--X-
------------------------------------------------------------------------X---------BB--------------X---XXX--------------------------------------------------------XX-X-----XXX-XX---XX---XX----XXXXXXX-X-
---X-----------------X--------------------------------------------------XX--------------X---X----XX--XXXX----BBB?BBB----------------B-------------------------o-XXXXX----XXXX-XXXXMXXX-XXX-o--XXXXXXXXXv
---XX---------------XX-----o--------------------------------------------XXX------------XX---XX--XXX-XXXXX---------------------------------------------------X--XXXXXX-X-XXXXX-XXXX-XXXXXXXX---XXXXXXXXXf
---XXX-------------XXX--------------------------------------------------XXXX--M-------XXX---XXXXXXXXXXXXXX-----------------o--------------------------------XXXXXXXXXXXXXXXXX-XXXXXXXXXXXXXX--XXXXXXXXXf
---XXXX-----------XXXX--------?-----------------------------------------XXXXX--XXXXX-XXXX---XXXXXXXXXXXXXXXX---X-------XX-----------------------------------XXXXXXXXXXXXXXXXX-XXXXXXXXXXXXXXX-XXXXXXXXXf
---XXXXX---------XXXXX-------------------------------------------XXXXXXXXXXXXX------XXXXX--BXXXXXXXXXXXXXXXX---XX--------------X-B--------------------------XXXXXXXXXXXXXXXXXXXXXXXXXXXXXXXXXXXXXXXXXXXf
---XXTXXX-------XXXXXX----------------B-----------T--------------T--T---XXXXXXX----XTXXXX-BBXXXXXXXXXTXXXXXXX--XXX-X----??-????XX--------------------------XXXXXXTXXXTXTXXXXXXXTTXXTXTTTXXTTXXXXTXXXXXXf
---XX|XXXX-----XXXXXXX----------------------------|--------------|--|---XXXXXXXX--XX|XXXX--XXXXXXXXXX|XXXXXXXXBXXXXX-----------XXX------------------------XXXXXXX|XXX|X|XXXXXXX||XX|X|||XX||XXXX|XXXXXXf
m--XX|XXXXX---XXXXXXXX--------E-------------------|--E-----------|--|---XXXXXXXXXXXX|XXXXEXXXXXXXXXXX|XXXXXXXXXXXXXXE-E-E------XXXXX---------------------XXXXXXXX|XXX|X|XXXXXXX||XX|X|||XX||XXXX|XXXXXXX
XXXXX|XXXXXXXXXXXXXXXXXXXXXXXXXXXXXXXXXXXXXXXXXXXX|XXXXXX-XXXXXXX|XX|---XXXXXXXXXXXX|XXXXXXXXXXXXXXXX|XXXXXXXXXXXXXXX----------XXXXXXXXXXXXXXXXXXXXXXXXXXXXXXXXXX|XXX|X|XXXXXXX||XX|X|||XX||XXXX|XXXXXXX
