------M---------------------------?---------------B-------------------------------------------------?---------------------------------------------------------------------------------------------------
------------------------------------------------------o-------------------o-------o---------------------------------------------------------------------------------------------------------------------
------------BBBB--------------------------B----------B------o----------------------M------M------------------o-----------------------------------------------------------------M---o--------------------
------------------------------------------------o----------------------------------------M--------------------------------------------------------------------------------------------------------------
----------------------------------o-------MBBBX--XXXXXXXXXXXXXXX--X-----------------------------------------------------------------------------------------------------o-------------------------------
---XBoB-X-?-------------------------------------XXX-o-----XX--XXXXXo-M---------o-o----------------------------------------------------------------------------------------------------------------------
---XX?--XXX----XB------------------X--X--BBBBBMXXXX------XXX-XXXXXXXo----MX--------------------------------------X--------------------------------------------------------------------------------------
---XXX--XXXX--XXBBBBBBBB-----------XX-XX?????-XXXXXXX--XXXXXXXXXXXXXX---X-XX--?----------------------------------XX-M----------?-----------------------------------------------------------------------v
---XXXX?XXXXXXXX-------------------XXXXXX----XXXXXX---XXXXXXXXXXXXXXXX-XX-XXX?XXXXXXXXX?--------X----------------XXX------X----------------------------------------------------------------------------f
---XXXXXXXXXXXXX-------------------XXXXXXX--XXXXXXX--XXXXXXXXXXXXXXXXXXXX-XXXX-XBBBBBXX--X-----XX------XXXXX-----XXXX-----XX---------------------------------------------------------------------------f
---XXXXXXXXXXXXX-------------------XXXXXXXXXXXXXXXX-XXXXXXXXXXXXXXXXXXXXX-XXXXXXX---XXX--XX---XXX----------------XXXXX----XXX----------BBBB---------X--------------------------------------------------f
---XXXXXXXXXXXXXX------o-----------XXXXXXXXXXXXXXXXXXXXXXXXXXXXXXXXXXXXXX-XXXXXXXX-XXXXB-XXX-XXXX----------------XXXXXX---XXXX---------------B-----XX--------------------------------------------------f
---XTXXXXXXTXTXTXX----------------TXXXTXXXTTXXXXXXTXTXXXXXTXXTTXXXXXXTXXXXXXXXTTXXXXTXT--XTXXXXXX-----T------T---XXXXXXX--XXXXX-------------------XXX--------------------------------T-----------------f
---X|XXXXXX|X|X|XXX----XXXX-------|XXX|XXX||XXXXXX|X|XXXXX|XX||XXXXXX|XXXXXXXX||XXXX|X|--X|XXXXXX-----|----o-|---XXXXXXXX-XXXXXX-----------------XXXX--------------------------------|------M----------f
m--X|XXXXXX|X|X|XXXXBBBB----------|XXX|XXX||XXXXXX|X|XXXXX|XX||XXXXXX|XXXXXXXX||XXXX|X|X-X|XXXXXX-----|------|-E-XXXXXXXXXXXXXXXXE--------------XXXXX--------------------------------|----------E------X
XXXX|XXXXXX|X|X|XXXXXXX----XXXXXXX|XXX|XXX||XXXXXX|X|XXXXX|XX||XXXXXX|XXXXXXXX||XXXX|X|XXX|XXXXXX-----|------|--XXXXXXXXXXXXXXXXXXXXXXXXXXXXXXXXXXXXXXXXXXXXXXXXXXXXXXXXXXXXXXXXXXXXX|XXXXXXBXXXXXXXXXXX
