---------------------------------------------------------------------------------------------o------------------------BBBBB--------------------------------------------------------------------?-o------
-----------------------------------------------------------------------------------o---------------------------o------MX--M-----------------------------------------------------------------------------
--------------------------------------------------------------------------------------------------------------M----------------------------------------------------------------------------------BBBXXX-
-----------------------------------------------------------------------------------------------------------M--------o-------------o---------------------------------------------------------B-----------
-------------------------------------------------------------------------------------------------------o----------------------o----------------------------------------------------------------------X--
--------------------------------------------------------------------------------------------------------------------------?M--o-------o----------------------------------------------------------o--XX--
-------------------------------------------------------------------------M---------------------------------X-------------------o-------------------------------------------------------------------XXX--
----------------------------------------------------------------------------------------------X----------o-X----------------------X---------------------------------------------------------------XXXX-v
---------------------------------------------------------------------------------------------XX--X-X--BMBBXX-------------X-------XX--------------------------------------------------------------XXXXX-f
---X--------------------------------------------------------------M-------------------------XXX-XX-XX----XXX-------------XX-B---XXX-------------------X-----------------------------------------XXXXXX-f
---XX----------------------------------------------------------------M---------------------XXXXXXX-XXX-XXXXX?------------XXX---XXXX------------------XX----------------------------------------XXXXXXX-f
---XXX------------------------------------------------------------------------------------XXXXXXXX-XXXXXXXXX-------------XXXX-XXXXX-----------------XXX---------------------------------------XXXXXXXX-f
---XXXX----------------------------------------------------------------TT--------TT----T-XXXXXXTXXTXXXXXTXXX?-------T----XXXXXXXXXX--T-----TT------XXXX---------------------------T---T------XXXXXTXTX-f
---XXXXX---------------------------------------------------------------||--------||-XXX|XXXXXXX|XX|XXXXX|XXXX-------|---oXXXXXXXXXX--|-----||-----XXXXX-------------------------X-|---|-----XXXXXX|X|X-f
m--XXXXXX---------------------------------------------------E-E--------||--------||----|XXXXXXX|XX|XXXXX|XXXXX------|----XXXXXXXXXX--|-----||---EXXXXXX------------------------XX-|--E|E---XXXXXXX|X|X-X
XXXXXXXXXXXXXXXXXXXXXXXXXXXXXXXXXXXXXXXXXXXXXXXXXXXXXXXXXXXXXXXXXXXXXXX||XXXXXXXX||XXXX|XXXXXXX|XX|XXXXX|XXXXXX--o-X|X---XXXXXXXXXXXX|XXXoX||XXXXXXXXXX-----XXXXXXXXXXXXXXXXXXXXXX|XXX|XXXXXXXXXXX|X|XXX
