----ET----?o---M-?E--M---E---T--o|-?---E|---XM--||---BBo------|-|---o-Xo-o?-----------|?--ME--TXMo|-TE-E-||?T-Mo-E----|---E|E|-T---TE--X--------BEoT----TX---BXT?-|--XT-X-o?---oM---E-----|?-|XE----X--E
-?B--E-T-B?B-|--?T-----TT?------oB-ME---T|-B-XX--E-MT-X-oM--|-----o---E--E--B?M|TE-MT-T---o-TM?-?--XB---M--XX---TB-o-|----B-To|?|-?B------EEB-?EXE-|T--E-oT---?--|--T-?----------M--|-MBM?M--E----?|M--?
oB---?----X-|?-----T--B?--BoBE-M--T-B-?M-?B?E-|-|X--E-X?--------M--T----X---o-?-T-X--BXoTB--MB-|--X---EX-BE-o--TT-o-o-BE-?-o--M--|--|-oMEo-MX---?---oE---?o--o?--?E-BE-X-T--?-B-?--?-|--?--TX---o-XX-o|o
B-XT--?-MB|M|--|-|---MX-----M-M-----M-M--XT----?---?o|-B-EX----oT--o-B--|-?o-XEE--M?--?-EBEX----E-M---?|BB?|-M-X--E--T-oM---M-Xo---TX?XT-M|o?E|---?--?----XT--|o-BB--E-MT-|-TM-?o?--o------?---M?-|BEo-X
?X---o|--BE-X--X--T|-TE|M-|--T----E--M-|--T--BE|---M------Mo-o--XEM-||-?--?----?-XBX|-E-X--X--TE-|-?---|?------XXM--X----X--E----TM-M--T--B-oE-MXoo-M-XB--EM-|---X--B-M?-?----|-|--BM----Mo-T--TT-TM--E|
|-B---?-o----X--BXEE-|----X-B-E---TT--|-TT--|B--XM-X-?-E---X--E-XM--TBB|E?-M---XXT-|E-----X|-MM---Eo?--------M-?---|o|---E-|--E-M|?oBX-oBMM-----E--|T--M-o---oB----X--E?---?-E----MT-MT-X-?|-----------|
E-|-BT|M?-T-?-o--B-|-T-X|---T-|E-??----o----BE-BB-oT--X--T--XE--|Eoo----T---T?--M-E-TE--|---?|E----|-?oX-XBM----||-X------T-o-ME-------o-E-?ME--XM?T?-BX--??-o--|B-B----X----E-MBM---ToM--?---T---X---||
|X|--T-MXX-TB--E-TT-MoT--EXE---X----T--MM--XoEoEET--|---?--EToo-T--?-o|--BEM?M-o-o-BM?X--TT?-----o-----------T--M----E-EE-B------|--|o-M--TXMB-?---B-Xo--X---XM--XXT-MB--o?E-T--X---?-?---Eo-----?E----v
|--MEM--?--M-T--E|TE|-o----EB--|-----|?-E--X|T|B-T---EBE---?-M--o-B-T------?--M-E-BM-XEo---o-XT---X-B-|--|-----?---?-----TXB--?--|-----X-M?---?M|XX---|-|-----oB--X---MM---E-X---?BMXT-T-|-o-X-X-MTM|M-T
o--|M---o-B-Mo-----X---ETE--------------?-MM-XM?TM-X-o--B-E-M-TE-TMBX-?---------Xo-T--o-B--M-MX?--o-BX|---------EMo-------?--M--|T-MEE---?B---o-o----o-X-----???-------X-o-o-o----B--|-?-o----|----oE--X
E---B?-o-|----M------X-XE?----?-??-T------|-TT-----To--EB?--X--|-Mo-----E----XX-T|-Eo--E|-T-T--Xo-TT-T|----|-B-B---MB|Eo----|?---B--MEE-|E-M--o-EE--EM--MB-----E|-T------?---|X-TEM-BMX|-XT|-||T------?o
o-oo---X-T---TT--ME--?B-M-E-TB|---Xo----X?-E--ME--X---o----?MBXB---EXo-E--o-B-ME--T--oEMT|?ET??-T-M|X?-TBTB----?B-o--|-MM------|--XT-T-----o-BEE--|B||--E-BE|--?--o---?-?|E-E---X---Bo------o---M--o?--X
T-E-MTE-T?-ooMB-M?-?-T|----T-B-EE-B-M-MTB-T--|----T-X|-E-oMBT-M--B--XTB--TE?-|X|T-E---oMEo---To---Eo--E--B-|E--E??--o?T??-M-M-M-BXB-|?-B|-To-|----------X--E-------ET-E|---B--TXT-|--------o----?----|ME
B--?---EMM---oME-M-|E-?X-----T--M---TX-----E-o-M--BEE-------?T-o-?EB---T??|E----B-?---|--E--XB-X-X|-----ET--------EX-o--Eo-E-?-X--B----o-?--T-|----T-BTo-?-------X-MTE-T|-||-E|-M--oo----X--X--?--B-|-M-
mB------TT-E|-|-T----Xo?------|-B--MTEB-----X-|-TM-o?-T--o-M---E---M-T-?---B-B?--MoT?E---EBB-BX--TBoT-?M-T---M---T--??--|-X-|-||o?--?M---||?-Bo----?|TBX--TB-----T------T--|?X-?|E?----B-|--X|-B-o-E---?
XXXXXXXXXXXXXXXXXXXXXXXXXXXXXXXXXXXXXXXXXXXXXXXXXXXXXXXXXXXXXXXXXXXXXXXXXXXXXXXXXXXXXXXXXXXXXXXXXXXXXXXXXXXXXXXXXXXXXXXXXXXXXXXXXXXXXXXXXXXXXXXXXXXXXXXXXXXXXXXXXXXXXXXXXXXXXXXXXXXXXXXXXXXXXXXXXXXXXXXX
