-M-------------------------------------------------------------------------------------------------------o----------------------------------------------------------------------------------------------
--------------------------------------------------------------------------------------------------------------------------------------------------------------------------------------------------------
--------------------------------------------------------------------------------------------------------------------------------------------------------------------------------------------------------
-----?--------------------------------------------------------------------------------------------------------------------------------------------------------------------------------------------------
--------------------------------------------------------------------------------------------------------------------------------------------------------------------------------------------------------
---------------------------------------------------------------o----------------------------------------------------------------------------------------------------------------------------------------
---X--X--------------------------------------------------------------------------------------------------X----------------------------------------------------------------------------------------------
---XX-XX-------------------------------------------------------------------------------------------------XX----XXXXXX----------------------------------------------------------------------------------v
---XXXXXX-------------------------------------------------------------------------------?---------------XXXX------------------------------------------------o------------------------------------------f
---XXXXXXX---------------------------------------------------------X-----------------------------------XXXXXX------------------X-----------------------------------------------------------------------f
---XXXXXXXX-----------------------------------------------------M-------------------------------------XXXXXXXX--X-------------XX--------X---X----------------------------X-----------------------------f
---XXXXXXXXX------------------------------------------------------------------------X----------------XXXXXXXXXX-XX????---?---XXX-----------------------------------------------------------------------f
---XXXXXXXXXX---------------------------------------------------T-------------------XX--------------XXXXXXXXXTXXXXX---------XXXX---T--------------------------------------------------------T----------f
---XXXXXXXXXXX--------------------------------------------------|------------B------XXX------------XXXXXXXXXX|XXXXXX-------XXXXX---|--------------------------------------------------------|----------f
m--XXXXXXXXXXXX-------------------------------------------------|-------------------XXXX----------XXXXXXXXXXX|XXXXXXX-----XXXXXX---|------------E-------------------------------------------|----------X
XXXXXXXXXXXXXXXXXXXXXXXXXXXXXXXXXXXXXXXXXXXXXXXXXXXXXXXXXXXXXXX-|-XXXXXXXXXX-------XXXXXXXXXXXXXXXXXXXXXXXXXX|XXXXXXXXXXXXXXXXXXXXX|XXXXXXXXXXXXXXXXXXXXXXXXXXXXXXXXXXXXXXXXXXXXXXXXXXXXXXXX|XXXXXXXXXXX
