-o?-X--|-?--M-XMB--X|-o--|--?---o---E-?XB---M-T--oB--T-o|o---?o----------|MT-oX-BE-B---E-----TE-X--T--?X---|?--X----?M-M--X-?Mo-E-E||o-B-T--E-To-TM---M--E--|-X--T-------E|--X-----?|X|-TX-X-o----M--|--
--|-XET-B--E--B-M--|T--XXE-----E---TX|-|o--XB----E-?B---BM-EX-?X----X-X------B-----T-X----o?E--X--oE-?XMoE-BXXo--M-E-?---|-|--|o--|M--M------X-X?E|--M?-XTBXM-o?XB--M-E---XT-B-|----Eo--ME--?-EB--M-|---
-M----o?-?---oo-|-----Xo---|XMoM--X|------o-B-XXEo-----|-oM-|-M-B-----|BE--|o|----T--E-TB|Bo-------T----|-----M--M-T--?-?-|o-TT-X-ET----?M-?E--M-M-o-Eo--|E-|--?o---X-|---M--?XMX-oX--M-|T?|ET?oX---?-B-
--T|E|||o---B---E|?E--?-T-o?ToB------T--o|E||T?M-X--TT-----X-M-oo--o|-M-?--E--B--X----oX-T-XE-|--T-?------E-?-|oBX-X?--X----T?B?--E--oM-----X--X---?-X-----T--X-M?o---o--B--|?X------o--X---?-----oEB-M-
-oE------MEET-To|---?---|XX-B-----------?-E|TBX-oBB-B--X--E--B----B--XET-oB-X|B|---X-ET---BToXX----XBT--T---oT-----B-T-E--?------BE-o-?M---?Eo--?o---EX-|---Mo--M-----X-M--o---|-?-?---X--E-----XE-MT-T-
--?TE--XEB--?T|B-Mo---??B----M------|-TMo---M--Bo------XT-M---BET-|E-----EoT--M---------MToT---B--M-M-T-T------?---|-?|-X-B---X--M-Mo---?-BoB-TBBM--o--BB--TEXX|TT|T--||T-o-X------MM--E?--X------?--M--
-o--|XB---To-T?-o-Xo----o-E----|---Xo-?--T-?--T-----||--E----B----T-----------TX---?EB---X-?-o------o-EMB-----X-?--?B----?-B-----T---|XX-BME---EB-o---E|To-T-B-|o--|?-E---?-M-B------o----M|-?M---EM----
----T-o|----XXB|---EBE-T-X-TXM----|o--M-B-|M---M-----?----o--|X----o--B---|-----X---||---E-----o-X--M-----|--M|-X---Eo-M--?X?MT----|--B?-----ToM-T?X-oXM-X-M--?||o?--MM---MTM-?-T-|M-|oE--B---B--|T-o|-v
-o-|--?-?X----X--Mo--|-TT-oEMXB---T--|?-|--XT?---|-----E---T------|----|MT-M-E-To---oB--T-|o---|T--TBE?T-|B-B|EM-M-|o---||-?B?-?B------E-B-E-oooT-E--Xo-X---------|----oM--?---ooM-X|E---MX---B--oX----f
-X-------MMXE---o-EXTXE---?---B?B---BB--EoM-M----X-T--?-|-?---o-TM|---MMT--TT--o|------B--BX---T?-|T-BE---EX?---M-T--X----E-Moo-o----?X-X-E-?X-EEX---T---M--?-?---EX-|----BM??-------BXE--T---B--E-----f
-----|-TTTEB--o-M?BE---ooEoX--E--Mo---E-M-|-?M--||--M----?X------?---E?--|EMME-?-X-ETT-XB-E--|oXT--X?E-X--EBo-----TBT-BTE--o-E--------B-?T|--??-o----|??-?--B-EMEo--|-T-E-E-----|-M-MBEM-oB-?-E-?-oMX?Bf
-|oT------E-----E----|----T?-?-Xoo---|--TT---X--oBo-------BXM-?-?T-|?-E-To----o--MB-E-T--oB|-MBB-B----T-Eo-|--Boo---BM?T---?BEBBBB-B?o----B-BT|-?-|X-?--BoE---X?--X--M-----MT--B---o-T-B----B-?X-|oXTMEf
-T-oE-------oX?X---EX-T?-?----|--X---o--oE-XB--X-o|--?--M--?X?----TT-ME------o-o|---M---XM--E-o-M|-------|----EE---E--?-MTBM--oB---?-X-To------B|T---?------BXB---M---MB|-T-M--E--ETT----TM----T--|---Ef
--oE---T---B--------B--o--XE-B----------T-EEE--?XX---oo---BM--B|----XX----?---M-o---X--X--X---X------B---X--X--o|--B--|----B-E-B-B-ME--oE--|---?B--M---o-B--T--BX----E--XX--M-M-|T---X---B----?M----o--f
mXoEo-----T----oE--B----o??-X---E?--E---XB---T|--ooBE--E|-TX----BEo-X--------ET---B--E---o-oX--B-X--?BE-|MT------TXX-BB--TMoBX--|B-TEoE---T-?---?-X--E---oE--|M--?-o-----?|--EBBEoo|----T-?--EE--B-X--BX
XXXXXXXXXXXXXXXXXXXXXXXXXXXXXXXXXXXXXXXXXXXXXXXXXXXXXXXXXXXXXXXXXXXXXXXXXXXXXXXXXXXXXXXXXXXXXXXXXXXXXXXXXXXXXXXXXXXXXXXXXXXXXXXXXXXXXXXXXXXXXXXXXXXXXXXXXXXXXXXXXXXXXXXXXXXXXXXXXXXXXXXXXXXXXXXXXXXXXXXX
