-M-------------------------------------------------------------------------------------------------------o----------------------------------------------------------------------------------------------
--------------------------------------------------------------------------------------------------------------------------------------------------------------------------------------------------------
--------------------------------------------------------------------------------------------------------------------------------------------------------------------------------------------------------
------------------------------------------------------------------------o-------------------------------------------------------------------------------------------------------------------------------
-------?------------------------------o------------------o-------------------------X--------------------------------------------------------------------------------------------------------------------
--------------------------------------X---X--------------------o----o-------------XX------------?-------------------------------------------------------------------------------------------------------
---X----------------------------------XX----------------------------------M------XXX---------------------------o----------------------------------------------------------------------------------------
-BBXXB--------------------------------XXX---------------------------------------XXXX---------------------X-----XXXXXXX---M-----------------------------------------------------------------------------v
---XXX-M------------------------------XXXX---------?---------------------------XXXXX--------------------XX----------XX--------------------------------------o------------------------------------------f
---XXXX-------------------------------XXXXX--------------------------XXXXX----XXXXXX-------------------XXX--B------XXX---------X-----------------------------------------------------------------------f
---XXXXX------------------------------XXXXXX--------------------M------------XXXXXXX------------------XXXX--X-----XXXX--------XX--------X--------------------------------X-----------------------------f
---XXXXXX-----------------------------XXXXXXX-------------------------------XXXXXXXXX----------------XXXXX-XX----XXXXX-------XXX-----------------------------------------------------------------------f
---XXXXXXX-T------------------------T-XXXXXXXXT----------T-TX---T-----TT---XXXXXXXXXXX---X-T-------TXXXXXXXXX---XXXXXX------XXXX---TT----------????????-------------------------------------T----------f
---XXXXXXXX|------------------------|-XXXXXXXX|----------|-|XX--|-----||--XXXXXXXXXXXXX-XX-|-------|XXXXXXXXX--XXXXXXX-----XXXXXo--||-------------------------------------------------------|----------f
m--XXXXXXXX|------------------------|-XXXXXXXX|X----E--E-|-|XXX-|-----||-XXXXXXXXXXXXXXXXX-|------X|XXXXXXXXX-XXXXXXXX--E-XXXXXX---||-----------E--------------------------------------E----|----------X
XXXXXXXXXXX|XXXXXXXXXXXXXXXXXXXXXXXX|XXXXXXXXX|XXXXXXXXXX|X|XXXX|-----||XXXXXXXXXXXXXXXXXXX|XXXXXXX|XXXXXXXXXXXXXXXXXXXXXXXXXXXXXXX||XXXXXXXXXXXXXXXXXXXXXXXXXXXXXXXXXXXXXXXXXXXXXXXXXXXXXXX|XXXXXXXXXXX
