-T------------o--------|---X-----------------------------------------------T----------------------------------------------o-----------T-------------------------------o-----------------o-----|----X----
----------------------E-----------------------|--------------T-----------------------E------------------------------------------------------------------------|---------|------------------------T------
--|-E--X--X--------------X--------E----------------------X----------------------------------------------------X---------|---T---E------------|--------|X------------------------------------------------
---------------------------------------T---------------E----o--E----------------------------------|--------------------------E--------------------------------------------------------------------------
---------------------o-------X------------|-----X----E-------------------|--------------------------------------------------------------------------------------------------X---------------------------
--------|-------------------------------------------|----o------------o---------------------------------------------------------------------------X-------------------------o-------------X-------------
-------------|-------------------E-------|--T-----------------------------------------------------------------------------X---E-----X--X---------EE---------------------T-----------------------X-------
------------------------------------------------------------------E------------------------------------E----------T----o----------------------------------------------------|--------------------------v
----------T--------X--------------|----o----------------------------------|o-------------------------------------T--o--------------------------T------------T------T----o--------------T---------------f
----------E----------------------------------------------------------X--------------X|------------------------------|-o-------------------------------------oE----X-------------T--|-------------------f
-------------------------------------o---o----------------|---------------------------------------------------------T----------------E----------|----------------------o----------------X--------------f
-----------------------------------------------E---------------------o-------E--------------X-----------------T-------------------X------------------X----o-----------------------------------------E--f
-----------E-----------------X---T---------------X-------------------T------X---------------------------oX-T--------------------------------------T--------------|---------T---------------------------f
---------------|---------------------X---------T---------o------------E-----|-------------------------o----E--------------------------------------------------------------------E----o-----------------f
m------------------------------------------------------------------------------------------------------------------------------------------------------------------------------------------------------X
XXXXXXXXXXXXXXXXXXXXXXXXXXXXXXXXXXXXXXXXXXXXXXXXXXXXXXXXXXXXXXXXXXXXXXXXXXXXXXXXXXXXXXXXXXXXXXXXXXXXXXXXXXXXXXXXXXXXXXXXXXXXXXXXXXXXXXXXXXXXXXXXXXXXXXXXXXXXXXXXXXXXXXXXXXXXXXXXXXXXXXXXXXXXXXXXXXXXXXXX
