------M-----------o---------------?-----------------------------------------------------------------?---------------------------------------------------------------------------------------------------
--------------------------------------------------------------------------o-------o---------------------------------------------------------------------------------------------------------------------
-----------XBBBBXX----?------------------------------------------------------------M-------------------------o-----------------------------------------------------------------M------------------------
------------------BXXBBBB-------------------------------------------------------------------------------------------------------------------------------------------------------------------------------
----------------B----X-----BBBBBBBB---------------------------------------------------------------------------------------------------------------------------------------------------------------------
---XBoB-X-?---------XX----------------X----------------------------o-M---------o-o----------------------------------------------------------------------------------------------------------------------
---XX?--XXX----XB-BXXXBBo---BBBBB--X-XX-----------------------------o-----X--------------------------------------X--------------------------------------------------------------------------------------
---XXX--XXXX--XXBBXXXX?B-----------XXXX-----------------------------------XX--?----------------------------------XX-M----------?-----------------------------------------------------------------------v
---XXXX?XXXXXXXX-XXXXX-----X-----X-XXXXX---------------------X------------XXX-XXXXXXXX-?-------------------------XXX------X----------------------------------------------------------------------------f
---XXXXXXXXXXXXXXXXXXX-----XX----XXXXXXX---------------------XX-----------XXXX-X-----------------------XXXXX-----XXXX-----XX---------------------------------------------------------------------------f
---XXXXXXXXXXXXXXXXXXX---X-XXX---XXXXXXX---------------------XXX----------XXXXXXX--------------------------------XXXXX----XXX-----------------------X--------------------------------------------------f
---XXXXXXXXXXXXXXXXXXX-o-XXXXXX-XXXXXXXXX--------------------XXXX---------XXXXXXXX-------------------------------XXXXXX---XXXX---------------B-----XX--------------------------------------------------f
---XTXXXXXXTXTXTXXXXXTT--XXXXTXXXXXXXXXXXX----------------T--XTXXX----?---XXXXTTXXX-T-T---T-----------T------T---XXXXXXX--XXXXX-------------------XXX--------------------------------T-----------------f
---X|XXXXXX|X|X|XXXXX||XXXXXX|XXXXXXXXXXXXX---------------|--X|XXXX-------XXXX||XXXX|-|---|o----------|----o-|---XXXXXXXX-XXXXXX-----------------XXXX--------------------------------|-----------------f
m--X|XXXXXX|X|X|XXXXX||BEXXXX|XXXXXXXXXXXXXX--------------|--X|XXXXX------XXXX||XXXX|E|X--|----E------|------|-E-XXXXXXXXXXXXXXXXE--------------XXXXX--------------------------------|-----------------X
XXXX|XXXXXX|X|X|XXXXX||--XXXX|XXXXXXXXXXXXXXXXXXXXXXXXXXXX|X-X|XXXXXXXXX--XXXX||XXXX|X|XXX|XXXXXXXX---|------|--XXXXXXXXXXXXXXXXXXXXXXXXXXXXXXXXXXXXXXXXXXXXXXXXXXXXXXXXXXXXXXXXXXXXX|XXXXXXBXXXXXXXXXXX
