-----------------------------------X--------------------------------------------------------------------------------------------------------------------------------------------------------------------
--------------------------------------------------------------------------------------------------------------------------------------------------------------------------------------------------------
----------------------------------------------------------------E------------o-------------------------------------------------------E---------------------T-------------------------o-T----------------
---------------------------------------------E--------------------------------------------X-------------------------------------------------------------------------------------------------------------
------------------------------X---------------|--------------------------------------------------------------------------------------------|------------------------------------------------------------
---X----------------------------------------------------------------------------------------------------------------------------------------------------------------------------------------------------
--------------------------------------------------------------------------------------------------------------------------------------------------------|-----------------------------------------------
-------------------------------------------------------------------------------------------------------------------------------------------------------------------------------------------------------v
-------------------------------------T----T----------------------T----------------------------------------------------------------------------------------X----------------o---------------------------f
-------------------------------------------------------|--------------------------------o------------------------------------E---------------------------------|---------------------------------------f
-------X------------------------------------------------------------------------------------------T-------------------T--------------------------------------------------------------------------------f
-------------------------------------X--------------------------------------------------o------T------------X-------------------------------------X----------------------------------------------------f
----------------------------------------------E---------------|------------------------------------------------------------------------------------T---X---------------------------o-------------------f
---------------------------------------X-----------------------------------o------------------------------------------------------------------------------------------------o------------------T-------f
m------------------------------------------------------------------------------------------------------------------------------------------------------------------------------------------------------X
XXXXXXXXXXXXXXXXXXXXXXXXXXXXXXXXXXXXXXXXXXXXXXXXXXXXXXXXXXXXXXXXXXXXXXXXXXXXXXXXXXXXXXXXXXXXXXXXXXXXXXXXXXXXXXXXXXXXXXXXXXXXXXXXXXXXXXXXXXXXXXXXXXXXXXXXXXXXXXXXXXXXXXXXXXXXXXXXXXXXXXXXXXXXXXXXXXXXXXXX
