--------------------------------------------------------------------------XXXXXXX--X----M--????????-----B---------o-------M-----------------------------------------------------------------------------
--------------------------------------------------------------------o-------------------------?--------------------?-B-----------------------------------------o--------XX----------XXXXXXX-------X-----
--------------------------------------------------------o-----------o-----M-------------------------------------------------------------------------------------------------------------?-------------B-
----------------------------------------------------------------------------------------------o-------o-------T--------------------------------------------------------------T----------BBBBBBBB--------
-------------T---------------------------------T---------------------------T-----------------T------T------X--|---------X--------------------------T-------------------------|---XXXBoXX--XTXXX---X-M---
-----o-------|---------------------------------|---------------------------|-----------------|-TXBT-|-----XX--|-----???XX???-----------------------|--------T----------------|--T--------XX|oX-?-XXB-XT-
-------------|---------------------------------|---------------------------|-----------------|-|XX|o|----XXX--|-------XXX--------------------------|--------|---------------T|--|X-X----XXX|XX--XXXo-X|-
-X-----------|---------------------------------|---------------------X-----|-o--------------B|B|XX|B|---XXXX--|------XXXX--------------------------|--------|---------------||--|--XT?-XXXX|XXBXXXX-XX|v
---X---------|---------------------------------|------?---X---------XX-----|------T--B------X|-|XX|X|--XXXXX--|-T---XXXXX--------------------------|--------|--T--------XXX-||--|--X|XXXXXX|XXXXTXXXXX|f
---XX--------|---------------------------------|----------XX-------XXX-----|?T????|--T-----XX|-|TX|X|BXXXXXX--|-|XXXXXXXX-----X--------------------|--------|--|------------||--|--X|XXXTXX|XXXX|XXXXX|f
---XXX-------|---------------------------------|----------XXX-----XXXX-----|-|--?-|--|-?T-XXX|-||X|X|TXXXXXX--|-|-XXXXXXXT----XX-------------------|--------|--|-BBBBB----M-||X-|--X|XXX|XX|XXXX|XXXXX|f
---XXXX------|---------------------------------|----------XXXX---XXXXX-----|-|--o-|--|-T|XXXX|-||X|X||XXXXTX--|-|XXXXXXXX|-T--XXX------------------|--------|--|---------X--||-M|--X|XXX|XX|XXXX|XXXXX|f
---XXXXX-----|---------------------------------|---------MXXXXX-XXXXXX----X|-|----|X-|-||XXXX|-||X|X||XXXX|XX-|-|XXXXXXXX|X|--XXXX-----------------|--------|--|--------XX--||--|-XX|XXX|XX|XXXX|XXXXX|f
---XXXXXX----|---------------------------------|----------XXXXXXXXXXXX----X|-|----|XX|-||XXXX|-||X|X||XXXX|XXX|X|XXXXXXXX|X|--XXXXX----------------|--------|--|-------XXT--||X-|XXX|XXX|XX|XXXX|XXXXX|f
mE-XXXXXXX---|--------------------------------E|-E----E---XXXXXXXXXXXX----X|X|---E|XX|X||XXXX|E||X|X||XXXX|XXX|X|XXXXXXXX|X|-oXXXXXX---------------|--------|--|------XXX|-X||--|XXX|XXX|XX|XXXX|XXXXX|X
XXXXXXXXXXXXX|XXXXXXXXXXXXXXXXXXXXXXXXXXXXXXXXX|XXXXXXXXXXXXXXXXXXXXXXXXXXX|X|XXXX|XX|X||XXXX|X||X|X||XXXX|XXX|X|XXXXXXXX|X|XXXXXXXXXXXXXXXXXXXXXXX|XXXX----|--|--o--XXXX|XX||-X|XXX|XXX|XX|XXXX|XXXXX|X
