-?MB-----B?MT-X-E-------?--oBE-|-|-XM--|?|----T--BT---EBE----?----EE----XB|-o?B-|----T--T--MTB-ET--o-BE-------|E----X-||--?M-||E-------TEM-TX-T---?TBo--E--B?---Xo?-M---?-o|-?|-?----BoMM--E-T-?-BMX-E--
-MMX-EB||X--X---X--T-E----X-M-?E?---Bo---o-|-MMX----EX-M--o-M?-----Bo--|---|----E-?--|T-------BM-|--?-X-------?oE-MEE-|--EoB---X|XB-T-?----E-?|--?X-B----MT?TB?--?B---Eo--B---M----M---B---E-B-X--|TB---
---XE----B-----|X?-M-XM|---|-EE?EooBX--B------------M-B-E-o?--o-B--BT----o--|B-----?--XE-E--XB---?--E--|EoB---|M?-BTB-TM----XTE--MoB-o--EE--T-o--X--|?--X-TXX-|-XT-?---M-M-E-T----XE----------B|-o--E-B-
-T-|-------B-X-E?T-X---EBE--X---?--oo-?-X-Eoo|-M-TBM--?T|-B----E------T-TE-B---MB--T-T--X---oB---B---|----M---T----?B-E--------XMoT---ET|-B-BX----?E-o?-M-T-X-B-E-?M-X----?-----|EMMT-?----oo-oB-B|X-X--
--BXX---------|-----XBX--X----T-?--o|--?----MEE|-o-------?------|o--?--X---T-B----|--E--M------|------------|E---B----|-TT-EB-EM-|---oM------Mo|-BX--B--BX--|--E--MB----BM-BM-M-T|?E------E-E--X---o--|-
---T-B?---Eo----------T--|o-X?---EX-o---Mo-oX--?-B-M?-E-EB-|?M-?X-B-MM---|?---M-T---M---?-----E--M-TB-M-X-E?-EX-?--TB-?|-?-T-|---X------XM--MBEo-X--E-M--M-XX---XX--??X?B-------BM--B-T-X---|-M--?Eo-X--
--XT--|X---M--BB------X-----BM---T-||B-B----E--M-o|E--B-----BM-M---EB-MX-T-M|----T-Xoo?--B?----M-EE-|-?B-T|----BX--o--E---M---M-BE--X?M?-EoTT?-T-T----o-oBE-o-B--oo|X----X--o-M-X------?E-T-M--|EE--|-M-
----oXX--o-E--MB-o|--?----|T|-B---E?-----|TE--TMM?-BE?-o--------M--M---o---T--B-EEX-MXBX----MoT-------o---|T--E-BX?--T-||-----M??B-X---o-|-|ToB-T-o-oX-?E-T---?MMT---------BE--Eo-BB|oX-o--|--M--|M---Xv
---M-----EXM?---ETTB|-M----M-M-B?T--TE-o-M-----?|B-o?----M-----X-------?Mo-BE-B---M----?-B-M--E---TE?-o-XE--?-----B---|E--oB?B-|--o--BE|oM-Bo?-BT?-T|-oMo-B-E-M-?--EEX|-|-M--E--E|---|-XX-----|o|XM|-o-f
-||--E-MX---o-----BX-MTE---B?-B--X-E-MT-Xo|?-X-Mo---oTBo-?TTBX-X-T--------T-o?--B-BX--|-M---BXEB-T----X-BB-XE--|----?--?-----X-|-B???---E--T--ToX---|ToX----?M-------MB-?---BT-----T-o--o---TB|--T-----f
--B--T--B--ME-E---E--?--|-?----ET--|E|---M----B-----oB--XB-?-XB---T--B|--|?-M|--EX-E-o-?TE??-------BTX-----X-TTXo?--X-B----T?--|---|o---?---X---T----EX?-?------MT---M-B--|---B-B?---X---TTo--T--|oTo--f
-E-----o------XE-T---M--ToTE----oo---B-oB-ME--T-X--X|--o--X|M-B----XB??X-|-o---o-----B--?--o---------B--------o--TX--?XTE------?----B-o-B-BMT-X||X--T|---BTX-M?XB-|--MXM----EoM--||--?E---TXB-X-|B-X?--f
------o-----|MT?-M--E?--M||--M-----B--E---XM-o-BT-BBX--o--TM--oT-----Bo-o---E-TBM|---oB-o?X--------o?----M-B----T?-|M-o?-oM----X-T---X---?-M|B--M--Xo-XX-?----E---?oTo-EB-o?X-XXTT-BX---o--?---BX-E-TX-f
-E-X?T------|---?-B-B-|--Boo-E---------M-|-E-E?-B-E--o---?M?|--o-B--T-B----B|B------||---||--B---E-T?--M|X--T-M|M-X-T----------|-E?X-----E?-X-E--BB--o---------T|||---------|o--E--?M--T--?EBo----o---|f
m-----M-X-|---XTTBBo----o-o-?-?TM------BX--X-BMTTE--M-----T-------E-|E|----|-E-|E|-T--M----E-B-X---T--X|---XE------B-M|-TE--B--|o----T-----XM-----XBo--B-----M-EMo---TET-X|--Xo--|T-EToT----T?--?|-?T--X
XXXXXXXXXXXXXXXXXXXXXXXXXXXXXXXXXXXXXXXXXXXXXXXXXXXXXXXXXXXXXXXXXXXXXXXXXXXXXXXXXXXXXXXXXXXXXXXXXXXXXXXXXXXXXXXXXXXXXXXXXXXXXXXXXXXXXXXXXXXXXXXXXXXXXXXXXXXXXXXXXXXXXXXXXXXXXXXXXXXXXXXXXXXXXXXXXXXXXXXX
