-M------------------------------------------------------------------------------------------------------------------------------------------------------------------------------------------------------
-------------------------------------------------------------------------?------------------?-----------------------------------------------------------------------------------------------------------
--------------------------------------------------------------------------------------------------------------------------------------------------------------------------------------------------------
------------------------------------------------------------------------o-------------------------------------------------------------------------------------------------------------------------------
----------------------------------------?---------------------------------------------------------------------------------------------------------------------------------------------------------------
---------------------------------------------------------------o----o---------------------------?-------------------------------------------------------------------------------------------------------
--------------------------------------------------------------------------M------------------------------------o----------------------------------------------------------------------------------------
---------------------------------------------------------------------------------------------------------X-----XXXXXXX---M-----------------------------------------------------------------------------v
---------------------------------------------------?----BBBBB-------------------------------------------XX----------XX--------------------------------------o------------------------------------------f
--------------------------------o-------------------B----------------XXXXX-----------------------------XXX--B------XXX---------X-----------------------------------------------------------------------f
----------------------------------------------------------------M-------------------------------------XXXX--X-----XXXX--------XX--------X--------------------------------X-----------------------------f
--------------------------------------------------M---------????--BBB--------------------------------XXXXX-XX----XXXXX-------XXX-----------------------------------------------------------------------f
----------------------------------------------TT---------T-TX---T-----TT?-----X----------X-T-------TXXXXXXXXX---XXXXXX------XXXX---TT----------????????-------------------------------------T----------f
----------------------------------------------||---------|-|XX--|-----||-----XX---------XX-|----X--|XXXXXXXXX--XXXXXXX-----XXXXXo--||-------------------------------------------------------|----------f
m---------------------------------------------||-------E-|-|XXX-|-----||----XXX-------XXXX-|----XXX|XXXXXXXXX-XXXXXXXX--E-XXXXXX---||-----------E--------------------------------------E----|----------X
XXXXXXXXXXXXXXXXXXXXXXXXXXXXXXXXXXXXXXXXXXXXX-||-----XXXX|X|XXXX|-----||---XXXXXXXXXXXXXXXX|X---XXX|XXXXXXXXXXXXXXXXXXXXXXXXXXXXXXX||XXXXXXXXXXXXXXXXXXXXXXXXXXXXXXXXXXXXXXXXXXXXXXXXXXXXXXX|XXXXXXXXXXX
