------------------------------------------------------------------------------------------------------M-------------------------------------------------------------------------------------------------
--------------------------------------------------------------------------------------------------------------------------------------------------------------------------------------------------------
-----------------------------------------------------o-----------------------------o--------------------------------?--------------------------------------------------------------X--------?-----------
--------------------------------------------------------------------------------------------------------------------Bo-------?----------------------------------------------------???-------------------
-----------------------------------------------------------------------------------------------------------------------X--------------------------------------------------------------------------------
-------o--------------------------------------------------------------------------------------------------------------XX--------------------------------------------------------------------------------
---------------------------------------------------------------------------------------------------------------------XXX----------------------------------------------------------------------X---------
-------------------------------------------------------------------------------------------------------------X------XXXX------------------------------------------------------XXXXXXXX-------XX--------v
------------------------------------------------------------------------------------------------------------XX--B--XXXXX--X-----------------------------------------------------------------XXX--------f
------------------------------------------------X---------------------M------------------------------------XXX----XXXXXX-XX----------------------------------------------------------------XXXX--------f
-----------------------------------------------XX-----------------------X---------------------------------XXXX---XXXXXXXXXX---------------------------------------------------------------XXXXX--------f
----------------------------------------------XXX-------?------------------------------------------------XXXXX--XXXXXXXXXXX--------------------------------------------------------------XXXXXX--------f
---------------------------------------------XXXX---------------------------------T-----------T--?T-T---TXTXXXTXXTXXXXXXXXX-------------------------------------------------------------XXXXXXX----T-T-f
--------------------------------------------XXXXX---------------------------------|---------?-|---|-|--X|X|XXX|XX|XXXXXXXXX------------------------------------------------------------XXXXXXXX--o-|-|-f
m------------------------------------------XXXXXX------------------X------------E-|-----------|---|-|-XX|X|XXX|XX|XXXXXXXXX-----------------------------------------------------------XXXXXXXXX----|-|-X
XXXX----------XXXXXXXXXXXXXXXXXXXXXXXXXXXXXXXXXXXXXXXXXXXXXXXXXXXXXXXXXXXXXXXXXXXX|XXXXXXXXXXX|---|X|XXX|X|XXX|XX|XXXXXXXXX-------XXXXXXXXXXXXXXXXXXXXXXXXXXXXXXXXXXXXXXXXXXXXXXXXX--XXXXXXXXXXXXXX|X|XX
