----------------------------------------------------------------------------------------------------------------------------------------------------------------------------M---------------------------
-------------------------------------------------------------------------------------------------------------------------------------------------------------------------------------------------?------
-------------------------------------------------------------------------------------------------------------------------------------------------------------------------------------X-----XXXXXXXX-----
------------------------------------------------------------------------------------------------------------------------------------------------------------------------------BBBBBB--------------------
---------------------------------------------------------------------------------------------------------------------------------------------------------------------B----------------X?---BBB---X------
------------------------------------------------------M---------------o----------X-XXXX-----X----------B-----------------------------------------------------------------------------XX---------XX-?----
------------------------------------X------------------------------------------------------XX----------------------------------------------------------------------------????????---XXX--------XXX------
-----X---------------------------------------------------o---X-----X-----------------B----XXX-----------------------------------------------------------?--------------------------XXXX-X-----XXXX-----v
-----XX---------------------------------------------?--------XX---XX---------------------XXXX-------------------------------------------------------------------------------------XXXXX-XX---XXXXX-X---f
-----XXX-----------------------------------------------------XXX-XXX--------------------XXXXX--------------------------------------------------------------------------------?---XXXXXX-XXX-XXXXXXXXB??f
-----XXXX--------------------------------------------X-------XXXXXXXX------------------XXXXXX---------------------------------------------------------------------X-------------XXXXXXX-XXXXXXXXXXXX---f
-----XXXXX-------------?---------------------XXXXXXXXX-------XXXXXXXX-----------------XXXXXXX---------------------------------------------------------------------XX-----------XXXXXXXXoXXXXXXXXXXXX---f
-----XXXXXX------------------------------T---------XXXBBBTT--XXXXXXXX-TT------T------XTXXXXXX--T------------------------------------------------------------------XXX-----o---XXXXXXXXT-XXXXTTXXXXXX-X-f
-----XXXXXXX-----------------------------|--------XXXX---||--XXXXXXXX-||------|-----XX|XXXXXX--|------------------------------------------------------------------XXXX-------XXXXXXXXX|-XXXX||XXXXXXo--f
m----XXXXXXXX----------------------------|-E-----XXXXX---||-XXXXXXXXX-||---EX-|----XXX|XXXXXXE-|-------------------------------------------------------------E----XXXXXEE---XXXXXXXXXX|XXXXX||XXXXXX---X
XXXXXXXXXXXXXXXXXXXXXXXXXXXXXXXXXXXXXXXXX|XXXXXXXXXXXXXXX||XXXXXXXXXXX||-XXXXX|XXXXXXX|XXXXXXXX|XXXXXXXXXXXXXXXXXXXXXXXXXXXXXXXXXXXXXXXXXXXXXXXXXXXXXXXXXXXXXXXXXXXXXXXX---XXXXXXXXXXX|XXXXX||XXXXXXXXXX
