-------------------------------------------------------------------------------------XXXX--------------------------------------B-?-MBBBBBBBBB--------------------------------??---------------------o---
---------------------------------------------------------------------------------------------------------------B-------M-------B------B-----------------------o----------------oBBBB-----------o--------
-----------------------------------------------------------------------------------o--o----------------------?o?-----------?--------M------------------------------BXXXXXXXXXXXXXXXXX---------?----M----
--------M--------------------------------------------------------------------------------------------T---M----XX-T---------X-----M-BBBBBB----------------------------------------------------T----XXXBX-
-----------------------------------------------------------------------------------------------------|M---T-BBX--|---------------X-?-TX-X---X----X-------------M--X-?????X??BBBXTT--BBB?B??-X|XXXXBB-X--
-----T---------------------------------------------------------------X-----------o-------------T-----|----|--XXB-|-BB-----XXXXXXXXT--|T--X----X-XX---------------XX--X--XX-?-?XX||---------XX|T---X-XXX-
-----|---------------------------------------------------o-----------XX----X-------------------|--X--|-To-|?XXX--|-----XX-XXXX-XXX|XX||XXX---oXXXX-------------XXXX--XXXXX---XXX||---X--X-XTX||--XXXXXX-
-----|X-------X------------------------------------------X-----X-----XXX---XX------XB------X---|B---o|-|--|XXXXT-|---oXXX-XXXXXXXX|--||XXX----XXXX-------------XXXX--XXXTX--XXXX||---XXXXXX|X||X-XXTXXXv
-----|--------XX-----------------------------------------------XX----XXXX--XXX----TXX-----XX--X|X----|B|--|XXXX|B|o-TXXXXoXXXXXXTX|--||XXXX--XXXXX------------XXXXX-XXXT|X-XXXXX||X--XXXXXX|X||XXXX|XXXf
-----|--------XXX----------------------------------------------XXX---XXXXX-XXXX---|XXX---XXX-XX|XXT--|-|-X|XXXX|-|--|XXXX-XXXXXX|X|--||XXXXXXXXXXXX------B---XXXXXXXXXX||XXXXXXX||XX-XXXXXX|X||XXXX|XXXf
-----|--------XXXX------o--------------------------------------XXXX--XXXXXXXXXXX--|XXXX-XXXXXXX|XX|T-|-|XX|XXXX|X|-X|XXTXTXTXXXX|X|XX||XXXXXTXXXXXXX--------XXXXXXTXXXX||XXXXXXX||XTXXXXXXX|X||XXXX|XXXf
-----|--------XXXXX--------------------------------------------XXXXX-XXXXXXXXXXXX-|XXXXXXXXXXXX|XX||-|T|XX|XXXX|X|XX|XX|X|X|XTXX|X|XX||XXXXX|XXXXXXXX------XXXXXXX|XXXX||XXXXXXX||X|XXXXXXX|X||XXXX|XXXf
-----|--------XXXXXX-------------------------------------------XXXXXXXXXXXXXXXXXXX|TXXXXXXXXXXX|XX||X|||XX|XXXX|X|XX|XX|X|X|T|XX|X|XX||XXXXX|XXXXXXXXX----XXXXXXXX|XXXX||XXXXXTX||X|XXXXXTX|X||XXXX|XXXf
-----|--------XXXXXXX------------------------------------------XXXXXXXXXXTXXXXXXXX||XXXXXXXXXXX|XX||X|||XX|XXXX|X|XX|XX|X|X|||XX|X|XX||XXTXX|XXXXXXXXXX--XXXXXXXXX|XXXX||XXXXX|X||X|XXXXX|X|T||XXXX|XXXf
m----|--------XXXXXXXX-----------------------------------------XXXXXXXXXX|XXXXXXXX||XXXXXXXXXXX|XX||X|||XX|XXXX|X|XX|XX|X|X|||XX|X|XX||XX|XX|XXXXXXXXXXXXXXXXXXXXX|XXXX||XXXXX|X||X|XXXXX|X||||XXXX|XXXX
XXXXX|XXXXXXXXXXXXXXXXXXXXXXXXXXXXXXXXXXXXXXXXXXXXXX-XXXXXX---XXXXXXXXXXX|XXXXXXXX||XXXXXXXXXXX|XX||X|||XX|XXXX|X|XX|XX|X|X|||XX|X|XX||XX|XX|XXXXXXXXXXXXXXXXXXXXX|XXXX||XXXXX|X||X|XXXXX|X||||XXXX|XXXX
