--------------------------------------------------------------------------------------------------------------------------------------------------------------------------------------------------------
--------------------------------------------------------------------------------------------------------------------------------------------------------------------------------------------------------
--------------------------------------------------------------------------------------------------------------------------------------------------------------------------------------------------------
--------------------------------------------------------------------------------------------------------------------------------------------------------------------------------------------------------
---------------------------------------------------------------------------------------------------------------------------------------------------------------------------------------?----------------
------------------------------------------------------M---------------o----------X---------------------B------------------------------------------------------------------------------------------------
------------------------------------X-------------------------------------------------------------------------------------------------------------------------------------------------------------------
-----X---------------------------------------------------o---X-----------------------B--------------------------------------------------------------------------------------------------X--------------v
-----XX---------------------------------------------?--------XX-------------------------------------------------------------------------------------------------------------------------XX-------------f
-----XXX-----------------------------------------------------XXX-X----------------------------------------------------------------------------------------------------------------------XXX------------f
-----XXXX----------------------------------------------------XXXXX--X-------------------------------------------------------------------------------------------------------------------XXXX-----------f
-----XXXXX-------------?---------------------XXXXXXXX--------XXXXX-XX------------------------------------------------------------------------------------------------------------------oXXXXX----------f
-----XXXXXX------------------------------T---------BBBBBBTT--XXXXXXXX-TT------T-------T--------T----------------------------------------------------------------------------------------XXXXXX-------X-f
-----XXXXXXX-----------------------------|---------------||--XXXXXXXX-||------|-------|--------|----------------------------------------------------------------------------------------XXXXXXX--------f
m----XXXXXXXX----------------------------|-E-------------||-XXXXXXXXX-||---EX-|-------|--E-E-E-|----------------------------------------------------------------------------------------XXXXXXXX---E---X
XXXXXXXXXXXXXXXXXXXXXXXXXXXXXXXXXXXXXXXXX|XXXXXXXXXXXXXXX||XXXXXXXXXXX||XXXXXX|XXXXXX-|----XXXX|XXXXXXXXXXXXXXXXXXXXXXXXXXXXXXXXXXXXXXXXXXXXXXXXXXX-XXXXXXXXXXXXXXXXXXXXXXXXXXXXXXXXXXXXXXXXXXXXXXXXXXXX
