--------------------------------------------------------------------------XXXXXXX--X----M--????????-----B---------o-------M-X---------------B--------------------??----------X--------------------------
--------------------------------------------------------------------o-------------------------?---------o----------?-B---------o-----o--XBBBB---------------X------------X?-o-------XXXXXXX-------X-----
--------------------------------------------------------o-----------o-----M--------------------------------------------------M---------------BBBBBBB--------------????XXXXXX-----?----X-?-------------B-
----------------------------------------------------------------------------------------------o-------o-------T--------------------MXXX-----------------------T--------------T-XXXXXX---BBBBBBBB--------
-------------T---------------------------------T---------------------------T-----------------T------T------X--|---------X------------M-----?????X-------------|----XXXXXXXX--|---XXXBoXo--XTXXX---X-o---
-----o-------|---------------------------------|---------------------------|-----------------|-TXBT-|-----XX--|-----???XX???-B--------M---o----XX-------------|----------XX--|--T-------BXX|XX-X-XX--XT-
-------------|---------------------------------|---------------------------|-----------------|-|XX|o|----XXX--|-------XXX-M-B-T-----------o---XXX---------????|---------XXX--|--|X------XXX|XXXXXXXoXX|-
-X-----------|---------------------------------|---------------------X-----|-o--------------B|B|XX|B|---XXXX--|------XTXX----o|M-T-T-X---X---XXXX------X--BBBB|B-------XXXX--|--|X--T?-XXXX|XXXXXXXXXX|v
---X---------|---------------------------------|------?---X---------XX-----|------T--B------X|-|XX|X|--XXXXX--|-T---XX|XX-----|--|-|XX--XX--XXXXX-----------o-|X---o--XXXXX--|--|XX-|-XXXXX|XXXXTXXXXX|f
---XX--------|---------------------------------|----------XX-------XXX-----|?T????|--To----XX|-|TX|X|BXXXXXX--|-|XXXXX|XX----X|-X|-|XX-XXXXXXXXXX-------------|XX????XXXXXX-T|--|XXX|XXXTXX|XXXX|XXXXT|f
---XXX-------|---------------------------------|----------XXX-----XXXX-----|-|--?-|--|-?T-XXX|-||X|X|TXXXXXX--|-|-XXXX|XXT----|XX|X|XXXXXXXXXXXXX-------------|XXXBBXXXXXXXX||--|XXX|XXX|XX|XXXX|XXXX||f
---XXXX------|---------------------------------|----------XXXX---XXXXX-----|-|--o-|--|-T|XXXX|-||X|X||XXXXTX--|-|XXXXX|XX|XT--|XX|X|XXXXXXXXXXXXXBB-----------|XXTXXXXXXXXXX||-M|XXX|XXX|XX|XXXX|XXXX||f
---XXXXX-----|---------------------------------|---------MXXXXX-XXXXXX----X|-|----|X-|-||XXXX|-||X|X||XXXX|XX-|-|XXXXX|XX|X|--|XX|X|XXXXXXXXXXXXXX------------|XX|XXXXXXXXXX||--|XXX|XXX|XX|XXXX|XXXX||f
---XXXXXX----|---------------------------------|----------XXXXXXXXXXXX----X|-|----|XX|-||XXXX|-||X|X||XXXX|XXX|X|XXXXX|XX|X|X-|XX|T|XXXXXXXXXXXXX-------------|XX|XXXXXTXTXX||X-|XXX|XXX|XX|XXXX|XXXX||f
mE-XXXXXXX---|--------------------------------E|-E----E---XXXXXXXXXXXX----X|X|---E|XX|X||XXXX|E||X|X||XXXX|XXX|X|XXXXX|XX|X|XX|XX|||XXXXXXXXXXXXX-------E-----|XX|XXXXX|X|XX||XX|XXX|XXX|XX|XXXX|XXXX||X
XXXXXXXXXXXXX|XXXXXXXXXXXXXXXXXXXXXXXXXXXXXXXXX|XXXXXXXXXXXXXXXXXXXXXXXXXXX|X|XXXX|XX|X||XXXX|-||X|X||XXXX|XXX|X|XXXXX|XX|X|XX|XX|||XXXXXXXXXXXXX---XXXXXXXXX?|XX|XXXXX|X|XX||XX|XXX|XXX|XX|XXXX|XXXX||X
