---------------------------------------------------------------------?-----------------------------------------------------------------------------XX-oXXXXXX---------------------B---------------------
--------------------------------------------------------------------------------------------------------M---------------------------------------------------------------------------o----?--?--o--------
----------------------------------------------------------------------------------------------------------------------------------------------------BBB----------??????---------------???---------------
------------------------------------------------------------------------------------------------------------------------------------------------------------------------???????---------------------B---
-------------------------------------------------------------------------------------------------------------X------------------------------------------------X-------BBB-------BX-------?X----X------X-
---------------------------------------------------------o--------------------------------------------X--B--XX-----------------------------------------------XX-----X--X--X-BBBBXXX-X-XX-XXX--XXX----XX-
-----------------------------------------------------------------------------------------------MX-----XX---XXX----------------------------------------------XXX----XX-XX-XXX---XXXX-XXXXXXXXXXXXXX--XXX-
-----------------------------------------------------------------------------------------------------BXXX-XXXX---------------------------------------BBBBBBXXXX-XXXXXXXXXXXXX?XXXXX-XXXXXXXXXXXXXX-XXXXv
------------------------------------------------------------------------------------------------------XXXXXXXX---------------------------------?------oo--XXXXX--XXXXXXXXXXXXXXXXXXXXXXXXXXXXXXXXXXXXXXf
-------------------------------------------------------------------X----------------------------X-----XXXXXXXX-------------------------------------------XXXXXX-XXXXXXXXXXXXXXXXXXXXXXXXXXXXXXXXXXXXXXXf
------------------------------------------------------------------------X---------------X----B-----X--XXXXXXXXX---------------------------------XXXXXX--XXXXXXXXXXXXXXXXXXXXXXXXXXXXXXXXXXXXXXXXXXXXXXXf
--------X-----------------------------------------------------------------------XXXXXX--XX-------o-o--XXXXXXXXXX---------------------------------------XXXXXXXXXXXXXXXXXXXXXXXXXXXXXXXXXXXXXXXXXXXXXXXXf
------------------------------------------------------------------T------T------T----T--XXX--T------BXXXXXXXXXXXX-----------------------------T--XTTT-XXXXXXXXXXTTXXXTTTXXXXXXXTXXXXTXXXXTTXXXXXTTXXTXXf
------------------------------------------------------------------|------|------|----|--XXXX-|------XXXXXXXXXXXXXX----------------------------|---|||XXXXXXXXXXX||XXX|||XXXXXXX|XXXX|XXXX||XXXXX||XX|XXf
m----o-E--------------------------------------X-------E-----------|--E---|??----|----|--XXXXX|-E---XXXXXXXXXXXXXXXX---------------------------|?-E|||XXXXXXXXXXX||XXX|||XXXXXXX|XXXX|XXXX||XXXXX||XX|XXX
XXX--------XXXXXXXXXXXXXXXXXXXXXXXXXXXXXXXXXXXXXXXXXXXXXXX-X---XXX|-----X|XXXXXX|XXX-|--XXXXX|----XXXXXXXXXXXXXXXXXXXXXXXXXXXXXXXXXXXXXXXXXXXX|---|||XXXXXXXXXXX||XXX|||XXXXXXX|XXXX|XXXX||XXXXX||XX|XXX
