---------------------------------------------------------------------------------------------o------------------------BBBBB-------------------------B---M-------------------------------o------?-o------
-----------------------------------------------------------------------------------o---------------------------o------MX--M--------------------o------------------------------XXXXXXX-------------------
--------------------------------------------------------------------------------------------------------------M----------------------o-----------------------------------------------------------BBBXXX-
-----------------------------------------------------------------------------------------------------------M--------o-------------o--------------X------------------------------------------B-----------
-------------------------------------------------------------------------------------------------------o----------------------o-----------------------------------X------X---------------------------X--
--------------------------------------------------------------------------------------------------------------------------?M--o-------o--------o----M------------XX-----XX-----------------------o--XX--
-------------------------------------------------------------------------M---------------------------------X-------------------o--------------------X-XM--X-----XXX----XXX----------XXXXXXXX-------XXX--
----------------------------------------------------------------------------------------------X------X---o-X----------------------XX--B---------X--??XX??XX-X--XXXX-?-XXXX-------------XX---------XXXX-v
---------------------------------------------------------------------------------------------XX--X-X-XXMBBXX-------------X-----B-XX---M-------------XXX-XXX---XXXXX--XXXXX------------XXX----X---XXXXX-f
---X--------------------------------------------------------------M-------------------------XXX-XX-XXXXX-XXX-------------XX-B---XXX----------------XXXXXXXX--XXXXXX-XXXXXX-----------XXXX-------XXXXXX-f
---XX----------------------------------------------------------------M---------------------XXXXXXX-XXXXXXXXX?------------XXX---XXXX-------------B-XXXXXXXXX-XXXXXXXXXXXXXX----------XXXXX------XXXXXXX-f
---XXX------------------------------------------------------------------------------------XXXXXXXX-XXXXXXXXX-------------XXXX-XXXXX----------X---XXXXXXXXXXXXXXXXXXXXXXXXX---------XXXXXX-----XXXXXXXX-f
---XXXX----------------------------------------------------------------TT--------TT----T-XXXXXXTXXTXXXXXTXXX?-------T----XXXXXXXXXX--TT--XTTTXX-XXXXTXXTXXXXXXXXXXXXXXXXXX--------TXXXTXX----XXXXXTXTX-f
---XXXXX---------------------------------------------------------------||--------||-XXX|XXXXXXX|XX|XXXXX|XXXX-------|---oXXXXXXXXXX--||--X|||XXXXXXX|XX|XXXXXXXXXXXXXXXXXX-------X|XXX|XX---XXXXXX|X|X-f
m--XXXXXX---------------------------------------------------E-E--------||--------||----|XXXXXXX|XX|XXXXX|XXXXX------|----XXXXXXXXXX?-||-EX|||XXXXXXX|XX|XXXXXXXXXXXXXXXXXX------XX|XXX|XX--XXXXXXX|X|XXX
XXXXXXXXXXXXXXXXXXXXXXXXXXXXXXXXXXXXXXXXXXXXXXXXXXXXXXXXXXXXXXXXXXXXXXX||XXXXXXXX||XXXX|XXXXXXX|XX|XXXXX|XXXXXX--o-X|X---XXXXXXXXXX--||--X|||XXXXXXX|XX|XXXXXXXXXXXXXXXXXXXXXXXXXX|XXX|XXXXXXXXXXX|X|XXX
