---------------------------------------------------------------------------------------------?--??????-----------o--------------o-----------------------------------------------------------------------
---------------------------------------------------------------------------------------------------------------------?-?-------------------------------------------------------------------------?------
-----------------------------------------------------------------------------------------------------------------------?-?------X----------------------------------------------------X-----XXXXXXXX-----
------------------------------------------------------------------------------------------?-------------X--------------------------------------------------X-----------------------------------X--------
--------------------------------------------------------------------------------------------------------------------?-BBBB------------------------------------X------B-----------------?----------------
------------------------------------------------------M---------------o----------X-XXXX-----X----------B-------------X------------X--------------------------XX--------------------X---------------?----
------------------------------------X-----------------------------------M------------X-----XX--?-------------o------XX-XXX-------XX-------------------------XXX--------------------XX-------------------
-----X---------------------------------------------------o---X-----X-----------------XX---XXXB---X-----------------XXX------X---XXX-------BXXXXXXX---------XXXX---------XX---------XXX--X--------------v
-----XX---------------------------------------------?--------XX---XX------------MX---XXX-XXXX----XX?--X-B-oo-----XXXXXB--X-XX--XXXX-----------------------XXXXX--------------------XXXX-XX---------X---f
-----XXX-----------------------------------------------------XXX-XXX------------XX---XXXXXXXX????XXX--XX---------XXXXX----XXX-XXXXX----------------------XXXXXX--------------------XXXXXXXX-----?BXXB??f
-----XXXX--------------------------------------------X-------XXXXXXXX----X----XXXX---XXXXXXXX----XXXX?XXX------?XXXXXX---XXXXXXXXXX-B-X-----------------XXXXXXX--------------------XXXXXXXXX-----XXX---f
-----XXXXX-------------?---------------------XXXXXXXXX-------XXXXXXXX---------XXXX---XXXXXXXX----XXXXXXXXX-----XXXXXXXo-XXXXXXXXXXX--XX----------------XXXXXXXX--------------------XXXXXXXXXX---XXXX---f
-----XXXXXX------------------------------T---------XXXBBBTT--XXXXXXXX-TT-----TTXXT---XTXXXTXX--TTXXXXXXXXXT-TTXXXTXTTT-TXTXXXXXXXXX-TXX--X-----B------XXXXXXXXX----------T---------XXXTXXXXXTT-XXXXX?X-f
-----XXXXXXX-----------------------------|--------XXXX---||--XXXXXXXX-||----X||XX|--XX|XXX|XX--||XXXXXXXXX|X||XXX|X|||X|X|XXXXXXXXXX|XX-XX-----------XXXXXXXXXX----------|--------MXXX|XXXXX||XXXXXXo--f
m----XXXXXXXX----------------------------|-E-----XXXXX---||-XXXXXXXXX-||---XX||XX|XXXX|XXX|XXX-||XXXXXXXXX|X||XXX|X|||X|X|XXXXXXXXXX|XXXXX-E--------XXXXXXXXXXX---------E|--------EXXX|XXXXX||XXXXXXo--X
XXXXXXXXXXXXXXXXXXXXXXXXXXXXXXXXXXXXXXXXX|XXXXXXXXXXXXXXX||XXXXXXXXXXX||-XXXX||XX|XXXX|XXX|XXXX||XXXXXXXXX|X||XXX|X|||X|X|XXXXXXXXXX|XXXXXXXXXXXXXXXXXXXXXXXXXXXXXXXXXXX-|-XXXXXXXXXXX|XXXXX||XXXXXXXXXX
