---------------------------------------------------------------------?--------------------------?????------------?----------------------------------------------------------------B---------------------
--------------------------------------------------------------------------------------------------------M---------------------------------------------------------------------------o----?--?--o--------
------------------------------------------------------------------------------------------------------------------o----------------------------------------------??????---------------???---------------
------------------------------------------------------------------------------------------------------------------------------------------------------------------------???????---------------------B---
-------------------------------------------------------------------------------------------------------------X?-------------------------------------------------------BBB-------BX-X-----?X----X------X-
---------------------------------------------------------o------------------------------------------o-X--B--XX---------------------------------------------------------X--X-BBBBXXXXX-XX-XXX--XX-----XX-
-----------------------------------------------------------------------------------------------MX-----XX---XXXX?-X----------------------------------------------------XX-XXX---XXXXXXXXXXXXXXXXX?X--XXX-
-----------------------------------------------------------------------------------------------------BXXX-XXXXXX-XX---------------------------------------------XXXXXXXXXXXXX?XXXXXXXXXXXXXXXXXXXX-XXXXv
------------------------------------------------------------------------------------------------------XXXXXXXXXXXXXXBBBBBB------------------------------------------XXXXXXXXXXXXXXXXXXXXXXXXXXXXXXXXXXXf
-------------------------------------------------------------------X----------------------------X-----XXXXXXXXXXXXXXX-----------------------------------------X----XXXXXXXXXXXXXXXXXXXXXXXXXXXXXXXXXXXXf
------------------------------------------------------------------------X---------------X----B-----X--XXXXXXXXXXXXXXXX----------------------------------------XX--XXXXXXXXXXXXXXXXXXXXXXXXXXXXXXXXXXXXXf
--------X-----------------------------------------------------------------------XXXXXX--XX-------o-o--XXXXXXXXXXXXXXXXX---------------------------------------XXXXXXXXXXXXXXXXXXXXXXXXXXXXXXXXXXXXXXXXXf
------------------------------------------------------------------T------T------T----T--XXX--T------BXXXXXTXXXXTXXXXXXXX--------------------------------------XXTTXXXTTTXXXXXXXTXXXXTXXXXTTXXXXXTTXXTXXf
------------------------------------------------------------------|------|------|----|--XXXX-|------XXXXXX|XXXX|XXXXXXXXX-------------------------------------XX||XXX|||XXXXXXX|XXXX|XXXX||XXXXX||XX|XXf
m----o-E--------------------------------------X-------E-----------|--E---|??----|----|--XXXXX|-E---XXXXXXX|XXXX|XXXXXXXXXX------------------------------------XX||XXX|||XXXXXXX|XXXX|XXXX||XXXXX||XX|XXX
XXX--------XXXXXXXXXXXXXXXXXXXXXXXXXXXXXXXXXXXXXXXXXXXXXXX-X---XXX|-----X|XXXXXX|XXX-|--XXXXX|----XXXXXXXX|XXXX|XXXXXXXXXXXXXXXXXXXXXXXXXXXXXXXXXXXXXXXXXXXXXXXX||XXX|||XXXXXXX|XXXX|XXXX||XXXXX||XX|XXX
