----------------o------X---o----XXX------X--X-------Bo---M--------B---------------------------BBBBBBB-o---XB------X-------------------------------------------------o----------------------------BB-----
---?------o--??o?BXXXXXB---------------XoXXXM-???----BoBBBBB-X------------------------M-----------------------?-----------BBBBBB---------------B-------------?------------------------------------BBBB--
------------------X---M-BBB--???????M---------B--BX---M-----------------------------------------------?----------o---BBBBBBB---Bo------------------------??---------------------------------------------
-----------BBBXXXXXXX-?--M---B---M-ooo------??????-B-------BBBBB------Bo-----------o-----------?------------X--o----o------------------------------------------------------------o----------------------
--------M?XXXXXoXX-B---XX-------X-?o--?-------?----B--?----------X--------?----------o-B---M----------o----X----M?------------------BBB-------------------------------BBBBBBB-------------------------X-
--------X------------X-XX-XBBBBXXBBBBB------o---XBB?-X--M------XXX---X-----------------XXXXXXX-------MXX-----------oM-X-----M--o-----------?------------------------------------o---------------------X-
---o????XXX?----X----XXXXXM---XXX---X-----X-o---XXXXXXXX------XXXXBBBXXB???B---------------------?---XX----o---X------XX--o--B---------------------o-----?--------X----o--------M---------------------X-
------o-XXXX--?XX?---XXXXXXXoXXXX---XX----XX---XXXX--XXX-----XXXXXX--XXX--X-----?-----X-----------o-XXXX-------XX---M-XXX------------X----------------------------------------------------------------Xv
--------XXXXXoXXX---XXXXXXXXXXXXXX--XXX-M-XXXBXXXXXXXXXXX--BXXXXXXX--XXXX-XXo----------------------XXXXXX------XXX----XXXX----------XX-----------X---------------------------------------------------XXf
--------XXXXXXXXX-XXXXXXXXXXXXXXXX--XXXX--XXXXXXXXXXXXXXXX?XXXXXXXX?-XXXXXXXXBBBBo--o----?X-------XXXXXXXX-----XXXX?B-XXXXX--------XXX-----------XX--------------XXXX-------X-----------------------XXXf
--M-B---XXXXXXXXXXXXXXXXXXXXXXXXX?X-XXXXXXXXXXXXXXXXXXXXXXXXXXXXXXX-XXXXXXXXXX---X---X--M-----o--XXXXXXXXXX----XXXXX--XXXXXX------XXXX---------o-XXX-BBBBBB----------------------------------------XXXXf
-------XXXXXXXXXXXXXXXXXXXXXXXXXX-o-XXXXXXXXXXXXXXXXXXXXXXXXXXXXXXX-XXXXXXXXXXX?XX--------------XXXXXXXXXXXX---XXXXXXXXXXXXXX????XXXXX-----X-----XXXX--------B----BBBBBB--------X----------o------XXXXXf
---T-T-TXTXTTXXXTTTXXXTXTTTTXTXTT-T-TTXTXTXXTXXTXXXTTTXXTTTXXXTTXXX-XTXXXTXXXTXXTT--T------TXT-TXXXXTXXXTXXXXT-XXXXXTTXXXXTXXX-TXXXXXT--X-XXT----XXXXXTX-T---------o-------TT----T-T-T-------T---XXXTTXf
---|-|X|X|X||XXX|||XXX|X||||X|X||X|-||X|X|XX|XX|XXX|||XX|||XXX||XXXXX|XXX|XXX|XX||--|---?--|X|X|XXXX|XXX|XXXX|-XXXXX||XXXX|XXXX|XXXXX|--XXXX|----XXXXX|X-|-----------X-----||----|-|-|-------|--XXXX||Xf
m-E|X|X|X|X||XXX|||XXX|X||||X|X||X|-||X|X|XX|XX|XXX|||XX|||XXX||XXXXX|XXX|XXX|XX||X-|EE-E--|X|X|XXXX|XXX|XXXX|XXXXXX||XXXX|XXXX|XXXXX|--XXXX|--E-XXXXX|X-|EE---E----XX---E-||E---|-|X|-------|-XXXXX||XX
XXX|X|X|X|X||XXX|||XXX|X||||X|X||X|X||X|X|XX|XX|XXX|||XX|||XXX||XXXXX|XXX|XXX|XX||X-|XX----|X|X|XXXX|XXX|XXXX|XXXXXX||XXXX|XXXX|XXXXX|-XXXXX|XXXXXXXXX|XX|XXX------XXX-----||XXXX|X|X|XXXXXXX|XXXXXX||XX
