-B----E---E--X-T------X?-----?---E-M--T-MXB|E---oEMT---XT---|-?MX-X-M-T-ToT?-?o--|-E|-M||-??---E-B-?|o|?T-E|---B-----X--o---|M||-X-?|-M-BX|---Eo-------B-|---B-X--|-M--?T--|-Eo-o---XXE-o-oo-EB-?---??--
-oT--T-Bo--E-|---o-T---oE--?MX--?--oX?EBTEX-B-o--|-----T--|X-----T-T---TX-T-|-TX?--B-XoEE--|?---BEX----X---oE----|--X-BBM-E--E?-BXM--X------BXE-E|----E----|-------MT?EEBX--T-----M-||--|X?oBB-?----T-|-
--TB-E|--?---M--|--EM-?-?---BE-X----|--B-?--BoMTE---M--X-?--|---ToE--M---B--E-BB---o-B----E----o-----B--X|?----oX--?-------XB--B-E--?oo?T---E-B-M-----B----------Eoo--|----oMT-X?--?---oETEXE-?-X-------
---ETo------BX-o|--T-?T-BEo-X|-----E---X-----X-M-----Mo?oB---------T----B------??|B----B|---------M-|--?-TX|-T?o|-X----|---|-?|-o--B?o-T----B--X-------o----M|o--?oE?o-M-BE-T-|-X------?|XEB--|?X?-|----
---Xo----------o--X-M---T---EM-|----B-ET|-?B?X------------XX----o---XTo-|--o|T-X--X--X-BT----|T--oMME---E-o------E|E-?-?--BEo---?|---T-EE---B---?---M-XTo|-----|-B|E-?--EE-E----|----X-|--oBoB?--B--o---
---?--o---T-----B-MMo|-XE--X-|---MX------Mo|-M--?B---X-BBXTEE-----?--M?-------|B--------oo-E-E--MET-----B--|o?-?--?M-|T-MMo-MX--EM-MoB----?----oTT--|B--------M--E-MB---oEX--|------|-----BB--|o||oE----
-|------|-?---?--M-B-B-?----B-o-?---T-TB---------B?E----o--|oT--T?|EX-----E---EM---o---?---TE-oM-------o|--||--EE-MB-T-T?TMEM-E-?B---|---|X|--M----E--X-ME--B-TT-B?-??---MT-----E?X-?-o?|--X--Mo-Eo--o--
-TE-E--ET?-B-B-|M--|------B--TEM-M--o-o?-T----XE-?M|--o-M-|-XTMB---oXE---BB-----?--X--T------B-----E-|-MB--T--|M-|--o---TT-B--------T-TE-T----T--oE-B-T|X?---|------To-Bo-?----E?XB----BBXo---E----oB?ov
-o-M?-?-|--------B----E--B-MM-X---T-B-----T-B---oTE-o-|TX-|----oBoE-B-----|--X|---?-M---T---oBXo?-E--X-X-----X----E-o---X--X--|---?-?|TME-?T--?--MX-?--o--|---MMBoT--B----|?----M---E-?-M??X-M-?--|B--Xf
----|--M|---XE-X-XE|----M-----E------TT---X-oEM-------o-B----B--M--|ETMooE-M-M--BT--o----B--?-----B-BX---|----?-T--??------X----|---BE-E----oT-------o-oB-XoM-B-B-E--?TMXM-M---T--------MM---E---X-----f
------B---EX-----?o---?o---?E-o--E---ToMBM-----oM---BT-X----TT-?EE--T-----||-M---Xo---B-----M-----?|B-E--TT--MT-E--X-E|TE--o--EEoX--ME---oE-o------o----E----o|o-X--EM|X-M-B-MB---|-----MT--XBB-ToB-?XMf
-EX?|-X-o-MM-E|o-B-|--|-oX?--E-E||?-T-oT--BMB---B----T?B?-?-|---?|---o?oM|------XB|------X----T----|-TToTBT---?E--EXo-TM----B-M---o-------|-|-----B-Bo-X--T--BMMX?-T--B--?-XXo-o?---o--||-o?-T-|-|-B---f
--M--T--o-MM--T--??MB-M---X|-XX|-?------XXEXoEB?E|---BMB-B|X---E--o-|--E-------o-T-?o-------TMB-X-o--M---M|----XTX-M-o|-----BB-MX-BMoX-M----X-X----TM-----TB---EX-------T--T--X-T----XoEEB-M-MM----MBX-f
---X---|-T?M-?--?Bo|-BB-M--T-?-|---EoBT---X--T-T-E-E----X-?B--X--?E-|M------E-----?METB-----------Eo----oXT-|-E---E---X?-?----B---B-|-T-M-M??o--oM--T--XE-XX-X||-X-M|-M-EE?-T---?-|--Eo-T?--|?--??--|Xof
m-B?-TM-?B?-oT--M--MXT----B?T--BXBB-M-o||-?M-EXXM--M--M---MX--E-E--?Mo----EEX---M-oT-?ME-?------M----oB-|X-M---|BE--o-B----M---XXE----B-M-Xo-------BT----M-XM--M---B-?T|E?BT----T-|--?B|EX--?--||Eo|---X
XXXXXXXXXXXXXXXXXXXXXXXXXXXXXXXXXXXXXXXXXXXXXXXXXXXXXXXXXXXXXXXXXXXXXXXXXXXXXXXXXXXXXXXXXXXXXXXXXXXXXXXXXXXXXXXXXXXXXXXXXXXXXXXXXXXXXXXXXXXXXXXXXXXXXXXXXXXXXXXXXXXXXXXXXXXXXXXXXXXXXXXXXXXXXXXXXXXXXXXX
