---------------------------------------------------------------------------------------------------------o----------------------------------------------------------------------------------------------
--------------------------------------------------------------------------------------------------------------------------------------------------------------------------------------------------------
--------------------------------------------------------------------------------------------------------------------------------------------------------------------------------------------------------
--------------------------------------------------------------------------------------------------------------------------------------------------------------------------------------------------------
-------------------------------------------------------------------------------------------o------------------------------------------------------------------------------------------------------------
---------------------------------------------------------------o----------------------------------------------------------------------------------------------------------------------------------------
---------------------------------------------------------------------------------------------------------X----------------------------------------------------------------------------------------------
---------------------------------------------------------------------------------------------------------XX----XXXXXX----M-----------------------------------------------------------------------------v
----------------------------------------------------------------------------------------?---------------XXXX------------------------------------------------o------------------------------------------f
-------------------------------------------------------------------X-----------------------------------XXXXXX------------------X-----------------------------------------------------------------------f
----------------------------------------BBBBBB------------------M-------------------------------------XXXXXXXX--X-------------XX--------X---X----------------------------X-----------------------------f
------------------------------------------------------------------------------------X----------------XXXXXXXXXX-XX????---?---XXX-----------------------------------------------------------------------f
------------------------------------------------------------------------------o-----XX--------------XXXXXXXXXTXXXXX---------XXXX---TT----------????????-------------------------------------T----------f
-----------------------------------------------------------------------------B------XXX------------XXXXXXXXXX|XXXXXX-------XXXXXo--||-------------------------------------------------------|----------f
m-----------------------------------------------------------------------------------XXXX----------XXXXXXXXXXX|XXXXXXX---E-XXXXXX---||-----------E-------------------------------------------|----------X
XXXXXXXXXXXXXXXXXXXXXXXXXXXXXXXXXXXXXXXXXXXXXXXXXXXXXXXXXXXXXXXXXXXXXXXXXXXX-------XXXXXXXXXXXXXXXXXXXXXXXXXX|XXXXXXXXXXXXXXXXXXXXX||XXXXXXXXXXXXXXXXXXXXXXXXXXXXXXXXXXXXXXXXXXXXXXXXXXXXXXX|XXXXXXXXXXX
