-------------------------------------------------------------------------------------XXXX--------------------------------------B-?-MBBBBBB?BB-XXXXXX-------------------------??---------------------o---
---------------------------------------------------------------------------------------------------------------B-------M-------B------B-----------------------B----------------oBBBB-----------o--------
-----------------------------------------------------------------------------------o--o----------------------?o?-----------?--------M------------------------------BXXXXXXXXXXXXXXXXX---------?----M----
--------M--------------------------------------------------------------------------------------------T--------XX-T---------X-----M-BBBBBB----------BBBBBB----------X-----------------------XXT----XXXXX-
-----------------------------------------------------------------------------------------------------|M---T-BBX--|---------------X-?-TX-X---T--T-X-------------M----???T?X??---XTT--BBB?B??-X|XXXXBB-X--
-----T---------------------------------------------------------------X-----------o-------------T-----|----|--XX--|-BB-----XXXXXXXXT--|T--X--|-X|XXX------------------X-|XX-?-?XX||---------XX|T---X-XXX-
-----|---------------------------------------------------o-----------XX----X-------------------|--X--|-To-|?XXX--|-----XX-XXXX-XXX|XX||XXX--|TX|XXX---------B--X-----XX|XX---XXX||---X--X-XTX||--XXXXXX-
-----|X-------X------------------------------------------X-----X-----XXX---XX------XB------X---|B---o|-|--|XXXXT-|---oXXX-XXXXXXXX|-X||XXX--||T|XXX------------XX-X--XX|TX--XXXX||---XXXXXX|X||X-XXTXXXv
-----|--------XX-----------------------------------------------XX----XXXX--XXX----TXX-----XX--X|X----|B|--|XXXX|B|o-TXXXXoXXXXXXTX|XX||XXXX-||||XXXX--?--------XXX--XXX||X-XXXXX||X--XXXXXX|X||XXXX|XXXf
-----|--------XXX----------------------------------------------XXX---XXXXX-XXXX---|XXX---XXX-XX|XXT--|-|-X|XXXX|-|--|XXXX-XXXXXX|X|XX||XXXXX||||XXXXX---------XXXXXXXXX||XXXXXXX||XX-XXXXXX|X||XXXX|XXXf
-----|--------XXXX------o--------------------------------------XXXX--XXXXXXXXXXX--|XXXX-XXXXXXX|XX|T-|-|XX|XXXX|X|-X|XXTXTXTXXXX|X|XX||XXXXX||||TXXXXX---------XXXTXXXX||XXXXXXX||XTXXXXXXX|X||XXXX|XXXf
-----|--------XXXXX--------------------------------------------XXXXX-XXXXXXXXXXXX-|XXXXXXXXXXXX|XX||-|T|XX|XXXX|X|XX|XX|X|X|XTXX|X|XX||XXXXX|||||XXXXXX--------XXX|XXXX||XXXXXXX||X|XXXXXXX|X||XXXX|XXXf
-----|--------XXXXXX-------------------------------------------XXXXXXXXXXXXXXXXXXX|TXXXXXXXXXXX|XX||X|||XX|XXXX|X|XX|XX|X|X|T|XX|X|XX||XXXXX|||||XXXXXXX-------XXX|XXXX||XXXXXTX||X|XXXXXTX|X||XXXX|XXXf
-----|--------XXXXXXX------------------------------------------XXXXXXXXXXTXXXXXXXX||XXXXXXXXXXX|XX||X|||XX|XXXX|X|XX|XX|X|X|||XX|X|XX||XXTXX|||||XXXXXXXX------XXX|XXXX||XXXXX|X||X|XXXXX|X|T||XXXX|XXXf
m----|--------XXXXXXXX-----------------------------------------XXXXXXXXXX|XXXXXXXX||XXXXXXXXXXX|XX||X|||XX|XXXX|X|XX|XX|X|X|||XX|X|XX||XX|XX|||||XXXXXXXXX-EE-XXXX|XXXX||XXXXX|X||X|XXXXX|X||||XXXX|XXXX
XXXXX|XXXXXXXXXXXXXXXXXXXXXXXXXXXXXXXXXXXXXXXXXXXXXX-XXXXXX---XXXXXXXXXXX|XXXXXXXX||XXXXXXXXXXX|XX||X|||XX|XXXX|X|XX|XX|X|X|||XX|X|XX||XX|XX|||||XXXXXXXXXXXXXXXXX|XXXX||XXXXX|X||X|XXXXX|X||||XXXX|XXXX
