---------------------------------------------------------------B----------------------------------------M--M--------------------X----------?-?----------------------------------------------------------
-----------------------------------------------------------------------------------------------------------------------------------------M----------------------X-----o-MBBBB----------X------???????---
--------------------------------------------------------------------------------------------------------------------------------------------------------------------B----------BBBB--B-------oX--o-M----
-------------------------------------------------------------------------------o------------------------------------------------------XB-?---------------------------?????--------------------------oo--
--------------------------------------------------------------------------------------------------------X--------------------------B---------?---M-----X------------------------------------------------
----------------------------------------------------------------------------------------X--------------XX-----X---------------------------------------XX---------------------------X----BBBXXXXXX-XX--X-
------------------------------------------------------------------------X---------BB--------------X---XXX------------------X------X------------------XXX-----------X----------o----XX---XX----XXXXXXX-X-
---X-----------------X--------------------------------------------------XX--------------X---X----XX--XXXX----BBB?BBBX-------X-----XXB-----------X---XXXX------o----XX-----------XXMXXX-XXX-o--XXXXXXXXXv
---XX---------------XX-----o--------------------------------------------XXX------------XX---XX--XXX-XXXXX----------XX-------XX----XXX----------XX--XXXXX-----------XXX----B---o----XXXXXXXX---XXXXXXXXXf
---XXX-------------XXX--------------------------------------------------XXXX--M-------XXX---XXXXXXXXXXXXXX--------XXX------oXXX---XXXX-X------XXX-XXXXXX-----------XXXXX--------X--XXXXXXXXX--XXXXXXXXXf
---XXXX-----------XXXX--------?-----------------------------------------XXXXX--XXXXX-XXXX---XXXXXXXXXXXXXXXX---X-XXXX--XX---XXXXX-XXXXXXX----XXXXXXXXXXX--------XXXXXXXX----X----XXXXXXXXXXXX-XXXXXXXXXf
---XXXXX---------XXXXX-------------------------------------------XXXXXXXXXXXXX------XXXXX--BXXXXXXXXXXXXXXXX---XXXXXX-X-----XXXXXXXXXXXXXXooXXXXXXXXXXXX-----------XXXXXX---XX-----XXXXXXXXXXXXXXXXXXXXf
---XXTXXX-------XXXXXX----------------B-----------T--------------T--T---XXXXXXX----XTXXXX-BBXXXXXXXXXTXXXXXXX--TXXTXXTXT??-TXXXTXXXXXXTXXXTXTXXXXXXXXXXX-------T---XXTXXXX--XXXTT-XTXTTTXXTTXXXXTXXXXXXf
---XX|XXXX-----XXXXXXX----------------------------|--------------|--|---XXXXXXXX--XX|XXXX--XXXXXXXXXX|XXXXXXXXX|XX|XX|X|X--|XXX|XXXXXX|XXX|X|XXXXXXXXXXX-------|---XX|XXXXX-XXX||XX|X|||XX||XXXX|XXXXXXf
m--XX|XXXXX---XXXXXXXX--------E-------------------|--E-----------|--|---XXXXXXXXXXXX|XXXXEXXXXXXXXXXX|XXXXXXXXX|XX|XX|X|E--|XXX|XXXXXX|XXX|X|XXXXXXXXXXX----E-E|EXXXX|XXXXXXXXX||XX|X|||XX||XXXX|XXXXXXX
XXXXX|XXXXXXXXXXXXXXXXXXXXXXXXXXXXXXXXXXXXXXXXXXXX|XXXXXX-XXXXXXX|XX|---XXXXXXXXXXXX|XXXXXXXXXXXXXXXX|XXXXXXXXX|XX|XX|X|---|XXX|XXXXXX|XXX|X|XXXXXXXXXXX----XXX|XX-XX|XXXXXXXXX||XX|X|||XX||XXXX|XXXXXXX
