---------------------------------------------------------------------?--------------------------?????------------?XX---?--------------?------------XX-oXXXXXX-------------------------------------------
--------------------------------------------------------------------------------------------------------M------------------------------------o-------------------------------------------------o--------
------------------------------------------------------------------------------------------------------------------o-----------------------o---------BBB----------??????---------------------------------
--------------------------------------------------------------------------------------------------------------------------------------------------------------------------------------------------------
-------------------------------------------------------------------------------------------------------------X?---M-----------o-------------------------------X-------BBB--------X-X--------------------
---------------------------------------------------------o------------------------------------------o-X--B--XX----XB-X--B----Xo---X----X---XXXX?XXXX--X------XX-----X--X--------XXXX-------X------------
-----------------------------------------------------------------------------------------------MX-----XX---XXXX??XX--X------XX---XX?--XX---XX------XXXX-----XXX----XX-XX-X-----XXXXX-------XX----o---oX-
-----------------------------------------------------------------------------------------------------BXXX-XXXXXXXXX--XX--M-XXXX-XXXXBXXXX--XXX--X-BXXXXBBBBXXXX-XXXXXXXXXX----XXXXXX---o---XXX--------Xv
------------------------------------------------------------------------------------------------------XXXXXXXXXXXXXXBXXXBBXXXXXXXXXXXXXXXX-XXXXXX?XXXXXo--XXXXX--XXXXXXXXX---XXXXXXX------XXXXX-----XXXf
-------------------------------------------------------------------X----------------------------X-----XXXXXXXXXXXXXXXXXXXXXXXXXXXXXXXXXXXXXXXXXXXXXXXXXX-XXXXXX-XXXXXXXXXX--XXXXXXXX-------XXXXX------Xf
------------------------------------------------------------------------X---------------X----B-----X--XXXXXXXXXXXXXXXXXXXXXXXXXXXXXXXXXXXXXXXXXXXXXXXXXXXXXXXXXXXXXXXXXXXX-XXXXXXXXX-------XXXXXX-----Xf
--------X-----------------------------------------------------------------------XXXXXX--XX-------o-o--XXXXXXXXXXXXXXXXXXXXXXXXXXXXXXXXXXXXXXXXXXXXXXXXXXXXXXXXXXXXXXXXXXXXXXXXXXXXXX-------XXXXXXX----Xf
------------------------------------------------------------------T------T------T----T--XXX--T------BXXXXXTXXXXTXXTTXTXXXTXXXTTXXXXXXTXXXXXXXXTXXXTTTXXXXXXXXXXXTTXXXXXXXXXXXXXXXXXXT------XXXXXTTX-TXXf
------------------------------------------------------------------|------|------|----|--XXXX-|------XXXXXX|XXXX|XX||X|XXX|XXX||XXXXXX|XXXXXXXX|XXX|||XXXXXXXXXXX||XXXXXXXXXXXXXXXXXX|------XXXXX||XX|XXf
m----o-E--------------------------------------X-------E-----------|--E---|??----|----|--XXXXX|-E---XXXXXXX|XXXX|XX||X|XXX|XXX||XXXXXX|XXXXXXXX|XXX|||XXXXXXXXXXX||XXXXXXXXXXXXXXXXXX|-E----XXXXX||XX|XXX
XXX--------XXXXXXXXXXXXXXXXXXXXXXXXXXXXXXXXXXXXXXXXXXXXXXX-X---XXX|-----X|XXXXXX|XXX-|--XXXXX|----XXXXXXXX|XXXX|XX||X|XXX|XXX||XXXXXX|XXXXXXXX|XXX|||XXXXXXXXXXX||XXXXXXXXXXXXXXXXXX|XXXXX?XXXXX||XX|XXX
