---------------------------------------------------------------------?--------------------------?????------------?----------------------------------------------------------------B---------------------
--------------------------------------------------------------------------------------------------------M--------------------------------------------------------------------------------?-----o--------
------------------------------------------------------------------------------------------------------------------o----------------------------------------------??????---------------???---------------
------------------------------------------------------------------------------------------------------------------------------------------------------------------------???????---------------------B---
-------------------------------------------------------------------------------------------------------------X?---M---------------------------------------------------BBB-------BX-------?X----X------X-
---------------------------------------------------------o------------------------------------------o-X--B--XX----XB---------X-----------------------------------------X--X-BBBBXXX-X-XX-XXX--XX-----XX-
-----------------------------------------------------------------------------------------------MX-----XX---XXXX?-XX---------XX----------------------------------------XX-XXX---XXXX-XXXXXXXXXXXX?X--XXX-
-----------------------------------------------------------------------------------------------------BXXX-XXXXXXXXX--------XXX----------------------------------XXXXXXXXXXXXX?XXXXX-XXXXXXXXXXXXXX-XXXXv
------------------------------------------------------------------------------------------------------XXXXXXXXXXXXXXBBBBBBXXXX-------------------------o------------XXXXXXXXXXXXXXXXXXXXXXXXXXXXXXXXXXXf
-------------------------------------------------------------------X----------------------------X-----XXXXXXXXXXXXXXX----XXXXX--------------------------------X----XXXXXXXXXXXXXXXXXXXXXXXXXXXXXXXXXXXXf
------------------------------------------------------------------------X---------------X----B-----X--XXXXXXXXXXXXXXXXX-XXXXXX--------------------------------XX--XXXXXXXXXXXXXXXXXXXXXXXXXXXXXXXXXXXXXf
--------X-----------------------------------------------------------------------XXXXXX--XX-------o-o--XXXXXXXXXXXXXXXXXXXXXXXX--------------------------X-----XXXXXXXXXXXXXXXXXXXXXXXXXXXXXXXXXXXXXXXXXf
------------------------------------------------------------------T------T------T----T--XXX--T------BXXXXXTXXXXTXXXXXXXXXXXXXX--------------------------XX----XXTTXXXTTTXXXXXXXTXXXXTXXXXTTXXXXXTTXXTXXf
------------------------------------------------------------------|------|------|----|--XXXX-|------XXXXXX|XXXX|XXXXXXXXXXXXXX--------------------------XXX--?XX||XXX|||XXXXXXX|XXXX|XXXX||XXXXX||XX|XXf
m----o-E--------------------------------------X-------E-----------|--E---|??----|----|--XXXXX|-E---XXXXXXX|XXXX|XXXXXXXXXXXXXX--------------------------XXXX--XX||XXX|||XXXXXXX|XXXX|XXXX||XXXXX||XX|XXX
XXX--------XXXXXXXXXXXXXXXXXXXXXXXXXXXXXXXXXXXXXXXXXXXXXXX-X---XXX|-----X|XXXXXX|XXX-|--XXXXX|----XXXXXXXX|XXXX|XXXXXXXXXXXXXXXXXXXXXXXXXXXXXXXXXXXXXXXXXXXXXXXX||XXX|||XXXXXXX|XXXX|XXXX||XXXXX||XX|XXX
