--------------------------------------------------------------------------------------------------------------------------------------------------------------------------------------------------------
--------------------------------------------------------------------------------------------------------------------------------------------------------------------------------------------------------
--------------------------------------------------------------------------------------------------------------------------------------------------------------X-----------------------------------------
----------------------------------------------------------------X---------------------------------------------------------------------------------------------------------------------------------------
-------------------------------------------------------------------------------------------------------------------------------------------------------------------------------o------------------------
-------------------------------------------------------------?-------------------------------------------------------------------------------------------------------------------------------------????-
---X--------------------------------------------------------------X-------------------------------------------------------------------------------------------------------------------------------------
--MXX------------------------------------------------------------XX---------------------------------------------------------------------------------B-----------------------------------o--------------v
---XXX----------------------------------------------------------XXX-------XXXX----------------------------------------------------------------------------------------------------------B-------------Xf
---XXXX--------------------------------------------------------XXXX------------------------------------------------------------------------------------------------------------------------------------f
---XXXXX------------------------------------------------------XXXXX------------------------------------------------------------------------------------------------------------------------------------f
---XXXXXX----------------------------------------------------XXXXXX------------------------------------------------------------------------------------------------------------------------------------f
---XXXXXXX------------------------------?-------------------XXXXXXX------------------------------------------?-----------------------------------------X-----------------?-----------------------------f
---XXXXXXXX------------------------------------------------XXXXXXXX-----------------------------------------------------------------------------------XX-----------------------------------------------f
m--XXXXXXXXX--------------------------------E-------------XXXXXXXXX--------------M-------------------------------------------------------------------XXX----E------------------------E-----------------X
XXXXXXXXXXXXXXXXXXXXXXXXXXXXXXXXXXXXXXXXXXXXXXXXXXXXXXXXXXXXXXXXXXXXXXXXXXXXXXXXXXXXXXXXXXXXXXXXXXXXXXXXXXXXXXXXXXXXXXXXXXXXXXXXXXXXXXXXXXXXXXXXXXXXXXXXXXXXXXXXXXXXXXXX-----XXXXXXXX-XXXXXXXXXXXXXXXXXX
