------------------------------------------------------------------------------------------------------------------------------------------------------------------------------------------X--M----------
------------------------------------------------------------------------------------------------------------------------------------------X-----------------------------o-???---------------------------
-------------------------------------------------------------------------------------------------------------------------------XXXXXXXX-----------------------------------------------X----BBXXXXXB-----
------------------------------------------------------------------------------------------------------------------------------------------------X---------------------------------XXXXXX----------------
--------------------------------------------------------------------------------------------------------------------B---------------------B----????????--------X-----------M----?X?-------B---?---------
-----------------------------------------------------------------------------------------------------------------------------------------------B------------?---------------Bo--XX-------------X--------
------------------------------------------------------------------------------------------------------------------------------------X----X-------B-----------------------------XXX----X--BBBB--XX-------
-----------------------------------------------------------------------------------------------------------------------------------XX---XX---------------M-?????-XXXXXX-------XXXX----XX----X--XXX-----v
--B-----------------------------------------------------------------------XXXX-------------------------------------------B--------XXX--XXX------------------------X----------XXXXX----XXX??-XX-XXXXXX--f
---------------------------------------------------------------------------------------------------------------------------------XXXX-XXXX----------------------------------XXXXXX----XXXX--XXXXXXXX---f
--------------------------------------------------------------------------------------------------------------------------------XXXXXXXXXX----------X---------------o------XXXXXXX-X--XXXXX-XXXXXXXXX--f
-------------------------------------------------------------------------------------------------------------------------------XXXXXXXXXXX----------XX--------------------XXXXXXXXXX--XXXXXXXXXXXXXXXX-f
----------------------------------------------------------------------------------------------------T--T-----?-------XXXXXXXX-XTXTXXXTTXXX--T--T-T--XXXT---T--XT--T------TXXXXXXXXXX-TXXTTXXXXXXXXTXXXXf
------------------------------------------------------------------------????????---------?----------|--|---------------------XX|X|XXX||XXX--|--|-|--XXX|---|-XX|--|-----X|XXXXXXXXXXX|XX||XXXXXXXX|XXXXf
m---------------------------------------------------------------------------------------------------|--|--------------------XXX|X|XXX||XXXX-|E-|-|E-XXX|X--|XXX|--|-E-EXX|XXXXXXXXXXX|XX||XXXXXXXX|XXXXX
XXXXXXXXXXXXXXXXXXXXXXXXXXXXXXXXXXXXXXXXXXXXXXXXXXXXXXXXXXXXXXXXXXXXXXXXXXXXXXXXXXXXXXXXXXXXXXXXXXXX|XX|XXBXXXXXXXXXXXXXXXXXXXX|X|XXX||XXXXX|--|B|BXXXX|XXX|XXX|--|---XXX|XXXXXXXXXXX|XX||XXXXXXXX|XXXXX
