--------------------------------------------------------------------------XXXXXXX--X-------????????-----B---------o----------------------------------------------??----------X------------------o-------
--------------------------------------------------------------------o-------------------------?---------------------------------------------------------------oo----X----XB-o?--------------------X-----
--------------------------------------------------------o-----------o-----M--------------------------------------------------------------------------???----------?????-----------------?-------------B-
----------------------------------------------------------------------------------------------o-------o-------T------------------------------------------T---BTBBBB?B--------T-XXXXXX---BBBBBBBB--------
-------------T---------------------------------T---------------------------T-----------------T------T------X--|---------X--------------------------------|-T--|----XXXXXXXX--|--?XXXBoXo--XTXXX---X-M---
-----o-------|---------------------------------|---------------------------|-----------------|--XB--|-----XX--|--------XX-----------------o-------------?|?|T?|----------XX-X|--T-------BXX|oX-X-XXB-XT-
-------------|---------------------------------|---------------------------|-----------------|--XX-o|----XXX--|-------XXX------------------------------T-|-||?|??-------XXXXT|--|X-X----XXX|XXXXXXXoXX|-
-X-----------|---------------------------------|---------------------X-----|-o--------------B|BBXXXB|---XXXX--|------XXXX------------------------------|-|B||B|B----???XXXXX||--|X-XT?-XXXX|XXXXXXXXXX|v
---X---------|---------------------------------|------?---X---------XX-----|------T--B------X|--XXXX|--XXXXX--|-----XXXXX--------------------------T---|-|-||-|T---o-?XXXXXX||--|XXX|XXXXXX|XXXXTXXXXX|f
---XX--------|---------------------------------|----------XX-------XXX-----|?T????|--T-----XX|--TXXX|BXXXXXX--|----XXXXXX--------------------------|---|X|-||-||XT---XXXXXXX||--|XXX|XXXTXX|XXXX|XXXXT|f
---XXX-------|---------------------------------|----------XXX-----XXXX-----|-|--?-|--|-?T-XXX|--|XXX|TXXXXXX--|---XXXXXXX-------------------M------|---|X|X||B||X|BBXXXXXXXX||X-|XXX|XXX|XX|XXXX|XXXX||f
---XXXX------|---------------------------------|----------XXXX---XXXXX-----|-|--o-|--|-T|XXXX|--|XXX||XXXXTX--|--XXXXXXXX--------------------------|---|X|X||-||X|XXXXXXXXXX||-M|XXX|XXX|XX|XXXX|XXXX||f
---XXXXX-----|---------------------------------|---------MXXXXX-XXXXXX----X|-|----|X-|-||XXXX|--|XXX||XXXX|XX-|-XXXXXXXXX--------------------------|---|X|X||X||X|XXXXXXXXXX||--|XXX|XXX|XX|XXXX|XXXX||f
---XXXXXX----|---------------------------------|----------XXXXXXXXXXXX----X|-|----|XX|-||XXXX|--|XXX||XXXX|XXX|XXXXXXXXXX--------------------------|---|X|X||-||X|XXXXXTXTXX||X-|XXX|XXX|XX|XXXX|XXXX||f
mE-XXXXXXX---|--------------------------------E|-E----E---XXXXXXXXXXXX----X|X|---E|XX|X||XXXX|EE|XXX||XXXX|XXX|XXXXXXXXXX--------------------E--E--|E-X|X|X||X||X|XXXXX|X|XX||XX|XXX|XXX|XX|XXXX|XXXX||X
XXXXXXXXXXXXX|XXXXXXXXXXXXXXXXXXXXXXXXXXXXXXXXX|XXXXXXXXXXXXXXXXXXXXXXXXXXX|X|XXXX|XX|X||XXXX|X-|XXX||XXXX|XXX|XXXXXXXXXXXXXXXXXXXXXXXXXXXXXXMXXXXX|XXX|X|X||X||X|XXXXX|X|XX||XX|XXX|XXX|XX|XXXX|XXXX||X
