---B-M--MT-----o|-M-B--B-o-----?|---T-E--o-o-TM---|EXM?-ET--T---Mo?X---T-X---TX|X|--M--E--M-----T--TBXT---------------X--T-?o--M------?Xo--EE---To-E--|--?|--EM??To-X-BX-M?-MEoXB--EE-oT?T---?-X-?-Mo?--
-?XT-----B-ToE---?X-?MEE?TB--X--E--XT-T--------E-oE--o-ooT--E---|M-----MM----X----M---X----B-M--?|----?---o--------|---o--ME---o---oTM-?-X-M|----Xo-o---XEMB---EM-o-------o|?o-T-|-T---T|-oB-XT-o-XM-T--
-o-----TT-|--|--E-E--E----B--T|TTT--T---T-E---T-E-X--MoE-EE---MM-|-BXoB-?-M----X------E|B----B---X--XBM-oM-o--TB-E--?---o-----E--B---M-Xo|--MXX-E-----|----------B--o---B-|EXE--?|EM------TX--X--o|--X--
--?--MoE--------ToM?----?Eo|-EX--|-?-o-?|E---?M-E-----------EMT----?E?------E-o----B--X-E-X--ooEo-?--X-|?---?oM---T-X---oTTX---B--B--?-E--MXM-E----?B-?-B-----B-XT--B-M----?|-M-EMMo----TM-Too-B---oETB-
--X|?--M-----?-------M-B--M--|-oXX------?-TE?-E-B-o-X--??-E|---EB---E-X---B---B-X-T--oT-----T--T-?-ET-T??M-?M-B-E-E--M----MM?--Too|--?-TT-T----T---?--Bo---|XX------|--Xo-?T-T-X-X------E?B--B?E-BM??---
-M-X-|X-B------|o---XB--T|o--BE-o----TT??-B-oB--X--?--X--TB-?|--|----B--MTT---|T--|-TX-oo--E-??M-B?---M--||?--E|oXM--T-B-?-|-o|XX--?-T-BoE-----Mo-E--oXB|---E-E--M|-?-----B|--E|---E--E-|--|M-E--o--XB--
---|-oX-|-T---X--|-EX---o-M---BB---T----E?o-EM-|-E----o-o|o--------X-oT--oX-|---E---------XBT--X--oo-|X----B-BT---------|--o--o--XTo?-T--E-B-BB--E-o----------ET-MM|-------?---|--|-?---oE---EoT--X--X--
---M----B-To-E-----o-BE-B-E----M|T----EB---X--X?--|-oE-oXX-E----E---ME-|------B--o|?-X-M--X-Eo-X-M-T----?M--B-M----MXo--X-XM-B---EXEXM-E-M-X|oT-X-o--?TXBMM----?--M-??-TX--TB--o|B-T-B-----|T-E--E-T-XXv
---TT--XoM---T----o-TBM-----oB--MX-M--------E---BM--XBo|E--?-E-|--E-X-TM-?To|---|----o--E-E??-T--T-----|-----oB----o----T-E-E-BEMEXoM?--|-oT--E?--B--o|--|---X-MMo--Moo--T-B----oooE?oT---o-||-XM-MB|--f
--?---oE-B--X-|E---|E--ToXo--E-?---ooT?--E----?---X-?E?--T---o-|---|-M--E?T|-BBM-MM--M?|-----o--MToTX|T-MM-T---T?-|--?Bo-X---T?|-M|-M---B---oM-M-?-|----|X---T----X---?-B--EB?--|X--Bo-E--XB--M----ME-Xf
--T---o----X-X-XMB---To----B---E-T?-|TT--------o-oT-----X---|T--ET-----|-|-|-M---E-X|T-|M-B---E|----EX--oX--oX-o-----|Xo-----B--E-|--oBBoT--M-E--TEMM-------|-M-------B---T-X-XB-E--Eo---TB----EMT---T|f
----?---oM?M?M-M--?B--X--MT--X-X?TMEEEET---oEM---o------B-T---XXT-----MTM-E----|T-|--M---o-oM?--o---o----|-------X?X----|-T---MBB----Bo---?-o-T-B--oo-M|---E-M-oE--M--BBXo-oB--o-T-T--TB-|--oXET-TM|Mo-f
-|-BXB--X-?--|---BM-M-X-||o|X--B--E-|-X?Bo?M-----EoX-E?BTXMMo---o|Bo-B-MM----?--B--B----?M---M|BE-Xo|---|M---oBBB-T--EMX-?XBT?----|-X-X-M----BE-o----T-o-----X-BM-----BB-B-------?-EM-???--MM-M--EX---?f
-B--BB----oM-X--BXMMMT---||--|-B----?----|--T--|M---B--B-M-||--?MXT||--|-B-?-E-B--?|--?oX--------E--?--|---X--B--EX-o----M-XX-?-oTooTMTE--M?--EB-T-E------E-|--?T--?-T-EE----Bo-X-|--T-|-XooM?E-o-MM?T-f
mB-|-M-T---EE--B-M-|--T----|-BME-----B-oT----o--BX---|EBB-X?M-E-XB-|--M-BT-X-M-EMo-----B-E--XBX---E-BX--B---E|B--o?XX|M-|TB|-X--B-E-|EX---|--|-BMoE-----B-?-E---oo--E-oE--MTooE-M-o-o-|-M-|---M---X?--XX
XXXXXXXXXXXXXXXXXXXXXXXXXXXXXXXXXXXXXXXXXXXXXXXXXXXXXXXXXXXXXXXXXXXXXXXXXXXXXXXXXXXXXXXXXXXXXXXXXXXXXXXXXXXXXXXXXXXXXXXXXXXXXXXXXXXXXXXXXXXXXXXXXXXXXXXXXXXXXXXXXXXXXXXXXXXXXXXXXXXXXXXXXXXXXXXXXXXXXXXX
