---------------------------------------------------------------------------------------------o------------------------BBBBB-------------------------B---M--------M-----------------------------?-o------
-----------------------------------------------------------------------------------o---------------------------o------MX--M--------------------o------------------------------XXXXXXX---------------?---
--------------------------------------------------------------------------------------------------------------M----------------------o---------------------------------------------------o-------BBBXXX-
-----------------------------------------------------------------------------------------------------------M--------o------------oo--------------X----------------------------------------XXBXXXX-------
-------------------------------------------------------------------------------------------------------o----------------------o---------------------------o-------X------X---------------------------X--
--------------------------------------------------------------------------------------------------------------------------?M--o-------o--------oM---M----------X-XX-----XX-----------------------o--XX--
-------------------------------------------------------------------------M---------------------------------X-------------------o--------------------X-XM--X----XXXX----XXX----------XXXXXXXX-------XXX--
----------------------------------------------------------------------------------------------X------X---o-X----------------------XX--B---------X--??XX??XX-X-XXXXX---XXXX------------------------XXXX-v
---------------------------------------------------------------------------------------------XX--X---XXMBBXX-------------X-----B-XX---M-------------XXX-XXX--XXXXXX--XXXXX-------------------X---XXXXX-f
---X--------------------------------------------------------------M-------------------------XXX-XX---XXX-XXX-------------XX-B---XXX----------------XXXXXXXX-XXXXXXXXXXXXXX----------------------XXXXXX-f
---XX----------------------------------------------------------------M---------------------XXXXXXX---XXXXXXX?---------XXXXXX---XXXX-------------B-XXXXXXXXXXXXXXXXXXXXXXXX---------------------XXXXXXX-f
---XXX------------------------------------------------------------------------------------XXXXXXXX---XXXXXXX-------------XXXX-XXXXX----------X---XXXXXXXXXXXXXXXXXXXXXXXXX--------------------XXXXXXXX-f
---XXXX----------------------------------------------------------------TT--------TT----T-XXXXXXTXXT--XXXTXXX?-------T----XXXXXXXXXX--TT--TTTTXX-XXXXTXXXXTXXXXXXXXXXXXXTXX-------TT---T------XXXXXTXTX-f
---XXXXX---------------------------------------------------------------||--------||-XXX|XXXXXXX|XX|--XXX|XXXX-------|---oXXXXXXXXXX--||--||||XXXXXXX|XXXX|XXXXXXXXXXXXX|XX------X||---|-----XXXXXX|X|XXf
m--XXXXXX---------------------------------------------------E-E--------||--------||----|XXXXXXX|XX|XXXXX|XXXXX------|----XXXXXXXXXX?-||-E||||XXXXXXX|XXXX|XXXXXXXXXXXXX|XX-----XX||--E|E---XXXXXXX|X|XXX
XXXXXXXXXXXXXXXXXXXXXXXXXXXXXXXXXXXXXXXXXXXXXXXXXXXXXXXXXXXXXXXXXXXXXXX||XXXXXXXX||XXXX|XXXXXXX|XX|XXXXX|XXXXXX--o-X|X---XXXXXXXXXX--||--||||XXXXXXX|XXXX|XXXXXXXXXXXXX|XXXXXXXXX||X-X|oXXXXXXXXXX|X|XXX
