--------------------------------------------------------------------------------------------------------------------------------------------------------------------------------------------------------
------------------|-------------------------------------------------------------------------------------------------------------------------------------------------------------------------------------
-----------------X----------------------------------------------------------------T------------------------------------T-------------E-------------------------X---------------------o-T----------------
----------------------------------------------------------------------------------------------------------------T----------------------------------------------------------o----------------------------
--------------------------------------------X------------------------------------------------------------------------------------------------------|----------------------------------------------------
------------X--------------------------------------------------------------------------------------------------------------------|----------------------------------------------------------------------
--------------------------------------------------------------------------------------------------------------------------------------------------------------------------------------------------------
--------X-----------------------------------------------------------------T-----------------------------------------------------------------------------------E----------------------------------------v
------------------------------------------------------------------------------------------------------------------------------------------------------------T------------------------------------------f
----------------------------------------------------------------------------------------o------------------------------------E---------------------------------|--------------------X------------------f
--------------------------------------------------------------------------------o-----------------------------------------------------------------------------------------------------X----------------f
---T------------------------------------------------------------------------------------o------E----------------------------T--------------------------------------------------------------------------f
-------------X------------------------------------------------|--------------------------------------------E-----------------------------------X-------X--------------------------------------------E--f
---------------------------------------X------------T------------------------------------------------------------------------o-----------------------------------------------------------------T---E---f
m------------------------------------------------------------------------------------------------------------------------------------------------------------------------------------------------------X
XXXXXXXXXXXXXXXXXXXXXXXXXXXXXXXXXXXXXXXXXXXXXXXXXXXXXXXXXXXXXXXXXXXXXXXXXXXXXXXXXXXXXXXXXXXXXXXXXXXXXXXXXXXXXXXXXXXXXXXXXXXXXXXXXXXXXXXXXXXXXXXXXXXXXXXXXXXXXXXXXXXXXXXXXXXXXXXXXXXXXXXXXXXXXXXXXXXXXXXX
