-------------------------M------------------------------------BBBBBBBXXXXXBBBBBBB------------------------oo-------------o-----o---------------------------------------------------------------o---------
----------------------------------o---------------------------------X-----------X-----------------X---BX------------------------------M---??????---o-------------------------?????-----??????-----------
----------------------------------------------------------------------------X-----?----?------------X---o--------------BBBBB-?------BBBBB-----------X-------------M----------------------------XXXXXX-o-
----------o---------------------------------------------------------o--------M-----------B-T------X---T-----------M----------------------------------------------------------------T-----M---T-------T--
--------------------------------o------------------------------oM--------------------?-----|-o--------|-----------???---M-X-X---T-o-T---------------M-----------------------------T|------Xo-|---XXXX|--
----------------------------------------------T----------------------T--BBBB--------------T|-----XT---|-????????---X-----XXXX---|---|--T-BT--X-----------X-------?------X---------||X-o-----X|----XXX|X-
----------------------------------------------|-----X----------------|---X----------X-X---||-----X|---|-----BBBBBMXX-T--XXXXX-o-|---|-B|--|-XX----------XX-X-------------B--------||X-------X|-------|X-
----------------------------------------------|-----XX-------------M-|--XX---------XXXX-BB||B-X--X|X--|----------XXX-|-XXXXXX---|T--|--|--|XXX-----M---XXXXX--------------------T-||X-------X|X-----X|Xv
----------X----------------------------o------|-----XXX--------------|-XXX------?-XXXXX---||T-XX-X|XX-|-----T--oXXXXT|XXXXXXT--o||-X|--|--|XXX---BBBBBXXXXXX----------??????XXXX|X||XM------X|XX---XX|Xf
----------XX----------------------------------|-----XXXX-------------|XXXX----X--XXXXXX-X-|||-XXXX|XXX|T-M--|--XXXXX||XXXXXX|---||-X|-o|-X|XXX-------XXXXXXX-----------------TBB|X||X-------X|XXX-XXX|Xf
----------XXX----------------T-------X--------|-----XXXXX----XXXXX---|XXXX----XXXXXXXXX-B-|||XXXXX|XXX||----|-XXXXXX||XXXXXX|XB-||MX|X-|XX|XXX------XXXXXXXX-----------T-----|?X|X||X------TX|XXXXXXX|Xf
----------XXXX---------------|--T----XX-------|-----XXXXXX----------X|XXXX----XXXXXXXXX-XX|||XXXTX|XXX||X--X|XXTXXXX||XXXXTT|XX-||-X|XX|XX|XXX-----XXXXXXXXX-----------|-----|XX|X||XT-----|X|XXXXXXX|Xf
----------XXXXX--------------|BB|BBB-XXX------|--X-?XXXXXXX---X----XX|XXXX-BB-XXXXXTXXX--X|||XXX|X|XXX||XXXX|XX|XXTT||XXXT|||XXX||-X|XX|XX|XXX----XXXXXXXXXX-----------|----?|XX|X||X|-----|X|XXXXXXX|Tf
----------XXXXXX-------------|-T|o---XXXX--M--|XXXX-XXXXXXXX-XX---XXX|XXXX---XXXXXX|XXX-XX|||XXX|X|XXX||XXXX|XX|XX||||XXX||||XXX||-T|XX|XX|XXX---XXXXXXXXXXX-----------|----X|XX|X||X|----o|X|XXXXXXX||f
m---------XXXXXXX--E----EE---|-||E---XXXXX-BE-|--XXXXXXXXXXXXXX--XXXX|XXXX-EXXXXXXX|XXXXXX|||XXX|X|XXX||XXXX|XX|XX||||XXX||||XXX||E||XX|XX|XXX-EXXXXXXXXXXXX--EE----XXX|X--XX|XX|X||X|----E|X|XXXXXXX||X
XXXXXXXXXXXXXXXXXX--XBBXXXXXX|X||XXXXXXXXXXXXX|XXXXXXXXXXXXXXXX-XXXXX|XXXX-XXXXXXXX|XXXXXX|||XXX|X|XXX||XXXX|XX|XX||||XXX||||XXX||X||XX|XX|XXXXXXXXXXXXXXXXX---MX-Xo---|--XXX|XX|X||X|---XX|X|XXXXXXX||X
