--------------------------------------------------------------------------------------------------------------------------------------------------------------------------------------------------------
--------------------------------------------------------------------------------------------------------------------------------------------------------------------------------------------------------
--------------------------------------------------------------------------------------------------------------------------------------------------------------X-----------------------------------------
----------------------------------------------------------------X------------------------------------------------------------------------------------------------------------BBBBBBBB-------------------
-------------------------------------------------------------------------------------------------------------------------------------------------------------------------------o----B-------------------
---------------------------------------------------------------------------------------------------------------------------------------------------------------------------------------------------????-
---X--------------------------------------------------------------X--------------------------------------------------------------------------------------X----------------------------------------------
--MXX------------------------------------------------------------XX---------------------------------------------------------------------------------B----XX-----------------------------o--------------v
---XXX----------------------------------------------------------XXX-------XXXX---------------------------------------------------------------------------XXX----------------------------B-------------Xf
---XXXX--------------------------------------------------------XXXX---------------------------------------------------------------------------------?----XXXX------------------------------------------f
---XXXXX------------------------------------------------------XXXXX--------------------------------------------------------------------------------------XXXXX-----------------------------------------f
---XXXXXX----------------------------------------------------XXXXXX--------------------------------------------------------------------------------------XXXXXX----------------------------------------f
---XXXXXXX------------------------------?-------------------XXXXXXX-----------------------------------------------------------------------------T--------XXXXXXX---------?-----------------------------f
---XXXXXXXX------------------------------------------------XXXXXXXX-----------------------------------------------------------------------------|--------XXXXXXXX--------------------------------------f
m--XXXXXXXXX----------------------------------------------XXXXXXXXX--------------M--------------------------------------------------------------|--------XXXXXXXXX-------------------E-----------------X
XXXXXXXXXXXXXXXXXXXXXXXXXXXXXXXXXXXXXXXXXXXXXXXXXXXXXXXXXXXXXXXXXXXXXXXXXXXXXXXXXXXXXXXXXXXXXXXXXXXXXXXXXXXXXXXXXXXXXXXXXXXXXXXXXXXXXXXXXXXXXXXX|XXXXXXXXXXXXXXXXXXXXXXX-----XXXXXXXXXXXXXXXXXXXXXXXXXXX
