-------------------------M------------------------------------BBBBBBBXXXXXBBBBBBB---------------------------------------------o------------------------------------------------------------o--o---------
----------------------------------o---------------------------------X-----------X------------------------------------------------------------------o----?--------------------?????----------------------
----------------------------------------------------------------------------X----------?---------------------------------------------B--------------------o--------o---------------X-----------XXXXXX-o-
----------o---------------------------------------------------------o--------M-----------------------------------------------------------------------------------------o-----------T-----M---T-------T--
--------------------------------o------------------------------oM--------------------?--------------------------------------------------------------------------------------------T|------Xo-|---XXXX|--
----------------------------------------------T----------------------T--BBBB---------------B-----X-------------------------------------------------------T-------?------X---------||X-o-----X|---BXXX|X-
----------------------------------------------|-----X----------------|---X------------X----------XX---------------------------------------------o--------|-X-------------B--------||X-------X|?------|X-
----------------------------------------------|-----XX-------------M-|--XX-----------XX----------XXX---------------------------------------------------T-|XX--------------------T-||X--T---XX|X-----X|Xv
----------X----------------------------o------|-----XXX--------------|-XXX------?---XXX----X-----XXXX--------------------------------------------------|-|XX----------?????XXXXX|X||XM-|---XX|XX---XX|Xf
----------XX----------------------------------|-----XXXX-------------|XXXX----X----XXXX----XX----XXXXX-------------------------------------------------|X|XX--------------XX-TBB|X||X--|---XX|XXX-XXX|Xf
----------XXX----------------T----------------|-----XXXXX----XXXXX---|XXXX----XX--XXXXX-B--XXXo--XTXXXX------------------------------------------------|X|XX-----------T-XXX-|?X|X||X--|X--TX|XXXXXXX|Xf
----------XXXX---------------|--T-------------|-----XXXXXX----------X|XXXX----XXXXXXXXX---XXXXX--X|XXXXX----------------------------------------------X|X|XX-----------|XXXX-|XX|X||XT-|XX-|X|XXXXXXX|Xf
----------XXXXX--------------|BB|BBB----------|--X-?XXXXXXX---X----XX|XXXX-BB-XXXXXXXXX--XXXXXXX-X|XXXXXX--------------------------------------------XX|X|XX-----------|XXXX?|XX|X||X|-|XXX|X|XXXXXXX|Tf
----------XXXXXX-------------|-T|o---------M--|XXXX-XXXXXXXX-XX---XXX|XXXX----XXXXXXXXX-XXXXXXXXXX|XXXXXXX------------------------------------------XXT|X|XX----------X|XXXXX|XX|X||X|B|XXX|X|XXXXXXX||f
m---------XXXXXXX--E----EE---|-||E---------BE-|--XXXXXXXXXXXXXX--XXXX|XXXX-E--XXXXXXXXXXXXXXXXXXXX|XXXXXXXX----------------------------E---E------EXXX||X|XX--------XXX|XXXXX|XX|X||X|-|XXX|X|XXXXXXX||X
XXXXXXXXXXXXXXXXXX--XBBXXXXXX|X||XXXXXXMXXXXXX|XXXXXXXXXXXXXXXX-XXXXX|XXXX--XXXXXXXXXXXXXXXXXXXXXX|XXXXXXXXXXXXXXXXXXXXXXXXXXXXXXXXXXXXXXXXXXX----XXXX||X|XX---M-X-oXXX|XXXXX|XX|X||X|X|XXX|X|XXXXXXX||X
