?--------------T--|-----TE------------------||?||------B?--B-----?--|---T--X-X-T--------E--E-MM-----o---T------------o----|---T-?-o-M--E----X--E-M------------------E-----------------------T---|?-T--XM
M-?--T?------------?T-X-o-EX|-----------------------o-B--------o|------X------|-|--M----|-T-M?-------------------T-------------------o----?-o--------o---|--B---B--TX?-|------------o-----?---o-M-----M-
|o-o-----X----------B--|o---E-T--------EM----T-----E-X--o--X------XB-----oE----T----------------------X-TX---T---T-------B------T------X---BE-X--E?E--o-----------T-----------oM|X-?-------B------M----?
---|o-XB--o-X----------|------M---T---?---o----XX-MM-----?--M-o------M---T-M|-M---o--?--M--T----?-oT----B---ME-----?------?--B-----BM-?-----M---X--EB--------o--M-|---E---------------------X--------M-?
X-Xo--------T---------------?T----|-B---oM------------X--BB|-o|---E|-oE----|----o-B----M--ToT??---XoB-|-o------------B--E----To-?----oX---M----|--?-----|----|EX--M??--oM---||--o-?M-------X-M---o?-T-BB
?---------------X-----?-M------o-|X----|--X-------XEE|---X-|---?B----------EE-----TE--o----o------oo?XX---TT--?-M---------------M-M|T--X-X----X---?---oEX-?|BXT-T----------T-o|-T---------|-------|T-?-M
---|--?-----M---B------M--|---o?-----o--TM--------?-----BX--------|--?----|------M-|-----?-------B---|--Bo-------M--T-----B-X--MT-----o-B-X-M-----------X--------|-------------T-----Eo---Mo------B-X--E
oM----|---------------TE-------o-----|X-------o------TE----oMB----B------E----X------------o--o|--BT?---T--X?---?---------E--B--M---TT|---oT----------B------T-B------E-----------------|----T---------v
E---|----E?|---o--X---M-----M---|----|--BB-----X------E-TT--X--oEM-o-B-E-BE-ETB----B?------?--|X-|-?---o---|----To---T--X--X----XM-T--?-|-|--------B---T-BBTE|--------------T--EM--T----------M--o-----T
|-o--E---------o----?---o--T------M--E--B-X-------XE?--EX-T-o-?---o--E-----M------|--X--------|?B--|X|--oBo--M|-----------MX-M-|E--X--B--T-??---------E--------o?-T-o---B------o------TB--------BM-E---|
T|o-?|--M-?o-------------------------T--oT----E---?----EXM-T------?-----o--B----E----------X--BE-|---------E-M--------MT--|--oo-?-------M-?|-B---B---------o--------T?--X---------------|------M---?BX-T
?X------?---o--------|T------------------XX-|BT-B--X-|-------X----------To-E-----X--E-?T|----?-----E-?X-E--E---------EX-----X-M--|-----?--X-------MEM------------------M---Eo----X----------------|-|-TT
-o--X---------|--o---BE-?-----E------o-----X---?o----T-----|o--------|--T--?--B-M--X-ETT-----M---M-----|----B-----To----?---o--X-?--Mo---|--|---X?----M?-M--T----|-------X--o-----X----B--E-B--B---B|--T
E-E-|-E?XB-|M--E-T------------T-o--Bo-E----E------E---------BT------o--E-------M-|---X?-------|------T------M--?XE------E-T--E---M-T--T----T---o--X-E-Xo-E---X?--------X----BX-E----|T---------?-E---?X|
m--MB---X---------|---?---E-T--|-M-----o-----|-------E---------B------X--M---X---?-------B---E-M-------X?---|----E-Bo-X--X-?---BME-M-X-------X--MX-----oT-----?--o-TM-?------------|?------------ET-E-o|
XXXXXXXXXXXXXXXXXXXXXXXXXX|XXXXXXXXXXXXXX|XXXXXXXXX-XXXXXXXXXXXXXXXXXXXXXXXXXXXXXXXXXXXXXXXXXXXXXXXXXXXXXXXXXXXXXXXXXXXXXXXXXXXXXXXXXXXXXXXXXXXXXXXXXXXXXXXXXXXXXXXXX-XXXXXXXXXXXXXXXXXXXXXXXXXXXXXXXXoX
