--------------------------------------------------------------------------------------------------------------------------------------------------------------------------------------------------------
--------------------------------------------------------------------------------------------------------------------------------------------------------------------------------------------------------
-------XXX----------------------------------------------------------------------------------------------------------------------------------------------------------------------------------------------
-----?------o-------------------------------------------------------------------------------------------------------------------------------------------------------------------------------------------
-----------------------------------------------------------------------------------X--------------------------------------------------------------------------------------------------------------------
-----------X-----------X----------------------------------------------------------XX--------------------------------------------------------------------------------------------------------------------
---X--X----XX---------XX---------------------------------------------------------XXX--------------------------------------------------------------------------------------------------------------------
---XX-XX---XXX-------XXX--------------------------------------------------------XXXX-------------------------------------------------------------------------------------------------------------------v
---XXXXXX--XXXX-----XXXX-------------------------------------------------------XXXXX------------------------------------------------------------------------o------------------------------------------f
---XXXXXXX-XXXXX---XXXXX------------------------------------------------------XXXXXX-------------------------------------------------------------------------------------------------------------------f
---XXXXXXXXXXXXXX-XXXXXX-----------------------------------------------------XXXXXXX----------------------------------------------------X--------------------------------X-----------------------------f
---XXXXXXXXXXXXXXXXXXXXX----------------------------------------------------XXXXXXXX-------------------------------------------------------------------------------------------------------------------f
---XXXXXXXXXXXXXXXXXXXXX---------------------------------------------------XXXXXXXXX--------------------------------------------------------------------------------------------------------T----------f
---XXXXXXXXXXXXXXXXXXXXX--------------------------------------------------XXXXXXXXXX--------------------------------------------------------------------------------------------------------|----------f
m--XXXXXXXXXXXXXXXXXXXXX-------------------------------------------------XXXXXXXXXXX------------------------------E-----E-------------------------------------------------------------------|----------X
XXXXXXXXXXXXXXXXXXXXXXXXXXXXXXXXXXXXXXXXXXXXXXXXXXXXXXXXXXXXXXXXXXXXXXXXXXXXXXXXXXXXXXXXXXXXXXXXXXXXXXXXXXXXXXXXXXXXXXXXXXXXXXXXXXXXXXXXXXXXXXXXXXXXXXXXXXXXXXXXXXXXXXXXXXXXXXXXXXXXXXXXXXXX|XXXXXXXXXXX
