---------------------------------------------------------------------?--------------------------?????------------?XX---?------------------------------o---------------------------B---------------------
--------------------------------------------------------------------------------------------------------M---------------------------------------------------------------------------o----?--?--o--------
------------------------------------------------------------------------------------------------------------------o----------------------------------------------??????---------------???---------------
------------------------------------------------------------------------------------------------------------------------------------------------------------------------???????---------------------B---
-------------------------------------------------------------------------------------------------------------X?---M-----------o---------------------------------------BBB-------BX-------?X----X------X-
---------------------------------------------------------o------------------------------------------o-X--B--XX----XB-X--B----Xo---X---------------------------------X--X--X-BBBBXXX-X-XX-XXX--XX-----XX-
-----------------------------------------------------------------------------------------------MX-----XX---XXXX??XX---------XX---XX?-------------------------------XX-XX-XXX---XXXX-XXXXXXXXXXXX?X--XXX-
-----------------------------------------------------------------------------------------------------BXXX-XXXXXXXXX--------XXXX-XXX-----------------------------XXXXXXXXXXXXX?XXXXX-XXXXXXXXXXXXXX-XXXXv
------------------------------------------------------------------------------------------------------XXXXXXXXXXXXXXBBBBBBXXXXXXXXX--------------------o---------XXXXXXXXXXXXXXXXXXXXXXXXXXXXXXXXXXXXXXf
-------------------------------------------------------------------X----------------------------X-----XXXXXXXXXXXXXXXX---XXXXXXXXXX-X-------------------------X-XXXXXXXXXXXXXXXXXXXXXXXXXXXXXXXXXXXXXXXf
------------------------------------------------------------------------X---------------X----B-----X--XXXXXXXXXXXXXXXXX-XXXXXXXXXXXXX-------------------------XXXXXXXXXXXXXXXXXXXXXXXXXXXXXXXXXXXXXXXXXf
--------X-----------------------------------------------------------------------XXXXXX--XX-------o-o--XXXXXXXXXXXXXXXXXXXXXXXXXXXXXXX---------------------X-?-XXXXXXXXXXXXXXXXXXXXXXXXXXXXXXXXXXXXXXXXXf
------------------------------------------------------------------T------T------T----T--XXX--T------BXXXXXTXXXXTXXTTXTXXXTXXXXXXXXXXXB-------------T-----XX--XXXTTXXXTTTXXXXXXXTXXXXTXXXXTTXXXXXTTXXTXXf
------------------------------------------------------------------|------|------|----|--XXXX-|------XXXXXX|XXXX|XX||X|XXX|XXXXXXXXXXX--------------|----XXXXXXXX||XXX|||XXXXXXX|XXXX|XXXX||XXXXX||XX|XXf
m----o-E--------------------------------------X-------E-----------|--E---|??----|----|--XXXXX|-E---XXXXXXX|XXXX|XX||X|XXX|XXXXXXXXXXXX-------------|-E-XXXXXXXXX||XXX|||XXXXXXX|XXXX|XXXX||XXXXX||XX|XXX
XXX--------XXXXXXXXXXXXXXXXXXXXXXXXXXXXXXXXXXXXXXXXXXXXXXX-X---XXX|-----X|XXXXXX|XXX-|--XXXXX|----XXXXXXXX|XXXX|XX||X|XXX|XXXXXXXXXXXXXXXXXXXXXXXXX|XXXXXXXXXXXX||XXX|||XXXXXXX|XXXX|XXXX||XXXXX||XX|XXX
