------------------------------------------------------------------------------------------------------M-----o-------------------------------------------------------------------------------------------
--------------------------------------------------------------------------------------------------------------------------------------------------------------------------------------------------------
--------------------------------------------------------------------------------------------------------------------------------------------------------------------------------------------?-----------
--------------------------------------------------------------------------------------------------------------------------------------------------------------------------------------------B-----------
-----------------------------------------------------------------------------------------------------------------------------------------------------------------------------------------------------B--
-------o------------------------------------------------------------------------------------------------------------------------------------------------------------------------------------B------M----
-----------------------------------------------------------------------------------------------------------------X----------------------------------------------------------------------------X-------X-
---------------------------------------------------------------------------------------------------------------------------------------------------------------------------------------------XX-------Xv
--------------------------------------------------------------------------------------------------------------------------------------------------------------------------------------------XXX-------Xf
------------------------------------------------X--------------------------------------XX---------------------------------------------------------------------------------------------XXXXXXXXX-------Xf
-----------------------------------------------XX-----------------------X-----------------------------------------------------------------------------------------------------------------XXXXX-------Xf
----------------------------------------------XXX----------------------------------------------------------------------------------------------------------------------------------------XXXXXX-------Xf
---------------------------------------------XXXX---------------------------------T-----------------------------------------------------------------------------------------------------XXXXXXXT-T-TTTXf
--------------------------------------------XXXXX---------------------------------|----------------------------------------------------------------------------------------------------XXXXXXXX|-|-|||Xf
m------------------------------------------XXXXXX-------------------------------E-|-E-----------------E--------------------------------------------------------------------------E----XXXXXXXXX|-|-|||XX
XXXX----------XXXXXXXXXXXXXXXXXXXXXXXXXXXXXXXXXXXXXXXXXX-----XXXXXXXXXXXXXXXXXXXXX|XXXXXXXXXXXXXXXXXXXXX----XXXXXXXXXXXXXXXXXXXXXXXXXXXXXXXXXXXXXXXXXXXXXXXXXXXXXXXXXXXXXXXXXXXXXoX--XXXXXXXXXX|X|X|||XX
