------------------------------------o-------------------------------------------------------------------------------------------------------------------------------------------------------------------
-------------------------------------------------------------------------------------------------------------------------------X------------------------------------------------------------------------
--------------------------------------------------------------------------------------------------------------------------------------------------------------------------------------------------------
----------------------------------------------------------------X--------------------------------B------------------------------------------------------------------------------------------------------
--------------------------------------------------------------------------------------------------------------------------------------------------------------------------------------------------------
-------------------------------------------------------------?-------------------------------------------------------------------------------------------------------------------------------------????-
---X--------------------------------------------------------------X-------------------------------------------------------------------------------------------------------------------------------------
--MXX------------------------------------------------------------XX---------o-----------------------------------------------------------------------B-----------------------------------o--------------v
---XXX----------------------------------------------------------XXX-------XXXX----------------------------------------------------------------------------------------------------------B-------------Xf
---XXXX--------------------------------------------------------XXXX----------------------X-------------------------------------------------------------------------------------------------------------f
---XXXXX------------------------------------------------------XXXXX---------------------XX-------------------------------------------------------------------------------------------------------------f
---XXXXXX----------------------------------------------------XXXXXX-----o--------------XXX-----------------------?-------------------------------------------------------------------------------------f
---XXXXXXX------------------------------?----------------T--XXTXXXX------------T------XXTX--TT---------T-------------XTXXXXXX-------------------T------------------------------------------------------f
---XXXXXXXX----------------------------------------------|-XXX|XXXX-----???????|-----XXX|XXX||X--------|--------------|-------------------------|------------------------------------------------------f
m--XXXXXXXXX--------------------------------E------------|XXXX|XXXX-E----------|-M-?XXXX|X--||---------|--------------|-------------------------|------------------------------------------------------X
XXXXXXXXXXXXXXXXXXXXXXXXXXXXXXXXXXXXXXXXXXXXXXXXXXXXXXXXX|XXXX|XXXXXXXXXXXXXXX-|---XXXXX|XXX||--------X|XXXXXXXXXXXXXX|XXXXXXXXXXXXXXXXXXXXXXXXX|XXXXXXXXXXXXXXXXXXXXXXXXXXXXXXXXXXXXXXXXXXXXXXXXXXXXXXX
