---------------------------------------------------------------B----------------------------------------------------------------------------------------------------------------------------------------
----------------------------------------------------------------------------------------------------------------------------------------------------------------------o-MBBBB----------X-----------??---
--------------------------------------------------------------------------------------------------------------------------------------------------------------------B----------BBBB-----------X--o------
-------------------------------------------------------------------------------o----------------------------------------------------------------------------------????????--------------------------oo--
--------------------------------------------------------------------------------------------------------------------------------------------------------------------????????----------------------------
----------------------------------------------------------------------------------------X------------------------------------------------------------------------------------------X----BBBXXXXXX-XX----
------------------------------------------------------------------------X---------BB-------------------------------------------------------------------------------X----------o----XX---XX----XXXXXXX---
---X-----------------X--------------------------------------------------XX--------------X---X----------------------------------------------------------------------XX-----------XXMXXX-XXX-o--XXXXXXXX-v
---XX---------------XX-----o--------------------------------------------XXX------------XX---XX---------------------------------------------------------------------XXX----B---o----XXXXXXXX---XXXXXXXXXf
---XXX-------------XXX--------------------------------------------------XXXX--M-------XXX---XXX----------X---------------------------------------------------------XXXXX-----------XXXXXXXXX--XXXXXXXXXf
---XXXX-----------XXXX--------?-----------------------------------------XXXXX--XXXXX-XXXX---XXXX---------XX----X------------------------------------------------XXXXXXXX----X----XXXXXXXXXXXX-XXXXXXXXXf
---XXXXX---------XXXXX-------------------------------------------XXXXXXXXXXXXX------XXXXX--BXXXXX--------XXX---XX--------------------------------------------------XXXXXX---XX-----XXXXXXXXXXXXXXXXXXXXf
---XXTXXX-------XXXXXX----------------B-----------T--------------T--T---XXXXXXX----XTXXXX---XXXXXX---T---XXXX--XXX------??---------------------------------------T-XXXXXXX--XXXTT-XTXXTXXXTTXXXXTXXXXXXf
---XX|XXXX-----XXXXXXX----------------------------|--------------|--|---XXXXXXXX--XX|XXXX---XXXXXXX-M|---XXXXXBXXXX----------------------------------------------|-XXXXXXXX-XXX||XX|XX|XXX||XXXX|XXXXXXf
m--XX|XXXXX---XXXXXXXX--------E-------------------|--E-----------|--|---XXXXXXXXXXXX|XXXXE--XXXXXXXX?|--EXXXXXXXXXXX------------------------------------------XXE|XXXXXXXXXXXXX||XX|XX|XXX||XXXX|XXXXXXX
XXXXX|XXXXXXXXXXXXXXXXXXXXXXXXXXXXXXXXXXXXXXXXXXXX|XXXXXX-XXXXXXX|XX|---XXXXXXXXXXXX|XXXXXXXXXXXXXXXX|XX-XXXXXXXXXXXXXXXXXXXXXXXXXXXXXXXXXXXXXXXXXXXXXXXXXXXXXXXX|-XXXXXXXXXXXX||XX|XX|XXX||XXXX|XXXXXXX
