------M-----------o---------------?---------------B-------------------------------------------------?---------------------------------------------------------------------------------------------------
------------------------------------------------------o-------------------o-------o---------------------------------------------------------------------------------------------------------------------
-----------XBBBBXX----?------------------------------B------o----------------------M------M------------------o-----------------------------------------------------------------M---o--------------------
-------------------XX---------------------------o----------------------------------------M--------------------------------------------------------------------------------------------------------------
---------------------X-----BBBBBBBB-----------X-----XXXXXXXXXXX---------------------------------------------------------------------------------------------------------o-------------------------------
---XBoB-X-?---------XX------------------------------o-----XX----XXXo-M---------o-o----------------------------------------------------------------------------------------------------------------------
---XX?--XXX----XB-BXXXBBo---BBBBB--X----------MM---------XXX-------Xo----MX--------------------------------------X--------------------------------------------------------------------------------------
---XXX--XXXX--XXBBXXXX?B-----------XX------------X-XX--XXXXX-------XX---X-XX--?----------------------------------XX-M----------?-----------------------------------------------------------------------v
---XXXX?XXXXXXXX-XXXXX-----X-----X-XXX-X--------------XXXXXX-X-----XXX-XX-XXX?XXXXXXXX-?--------X----------------XXX------X----------------------------------------------------------------------------f
---XXXXXXXXXXXXXXXXXXX-----XX----XXXXXXX-------------XXXXXXXBXXBBB-XXXXXX-XXXX-XBBBBBB---X-----XX------XXXXX-----XXXX-----XX---------------------------------------------------------------------------f
---XXXXXXXXXXXXXXXXXXX---X-XXX---XXXXXXX-------?----XXXXXXXX-XXX---XXXXXX-XXXXXXX--------XX---XXX----------------XXXXX----XXX----------BBBB---------X--------------------------------------------------f
---XXXXXXXXXXXXXXXXXXX-o-XXXXXX--XXXXXXXX----------XXXXXXXXX-XXXX--XXXXXX-XXXXXXXX-----B-XXX-XXXX----------------XXXXXX---XXXX---------------B-----XX--------------------------------------------------f
---XTXXXXXXTXTXTXXXXXTT--XXXXTXX-XTXXXTXXX--------TXTXXXXXTX-TTXXX-XXTXXXXXXXXTTXXX-T-T--XTXXXXXX-----T------T---XXXXXXX--XXXXX-------------------XXX--------------------------------T-----------------f
---X|XXXXXX|X|X|XXXXX||XXXXXX|XXXX|XXX|XXXX---o--X|X|XXXXX|X-||XXXXXX|XXXXXXXX||XXXX|-|--X|XXXXXX-----|----o-|---XXXXXXXX-XXXXXX-----------------XXXX--------------------------------|------M----------f
m--X|XXXXXX|X|X|XXXXX||BEXXXX|XXXX|XXX|XXXXX---EXX|X|XXXXX|X-||XXXXXX|XXXXXXXX||XXXX|E|X-X|XXXXXX-----|------|-E-XXXXXXXXXXXXXXXXE--------------XXXXX--------------------------------|----------E------X
XXXX|XXXXXX|X|X|XXXXX||--XXXX|XXXX|XXX|XXXXXXXXXXX|X|XXXXX|X-||XXXXXX|XXXXXXXX||XXXX|X|XXX|XXXXXX-----|------|--XXXXXXXXXXXXXXXXXXXXXXXXXXXXXXXXXXXXXXXXXXXXXXXXXXXXXXXXXXXXXXXXXXXXX|XXXXXXBXXXXXXXXXXX
