--------------------------------------------------------------------------------------------------------------------------------o-----------------------------------------------?-----------------------
------------------------------------------------------------------------------------------------------------------?--------B---B------------------------------------------------------------------------
-----------------------------------------------------------------------------------------------------------------------?--------X-----------------------------------------------------------------------
-----------------------------------------------------------------------------------------------------------------BBBB-----------------------------------------------------------------------------------
--------------------------------------------------------------------------------------------------------------------?-BBBB--------o----------------------------------------------------?----------------
------------------------------------------------------M---------------o----------X----------X------------------------X---------------o-X----------------------------------------------------------------
------------------------------------------------------------------------M------------X-----XX--?-------------o------XX-------?---------XX---------------------------------------------------------------
-----X---------------------------------------------------o---X-----X-----------------XX---XXXB---X-----------------XXX------X----o-----XXX-XXXXXXX--------------------------------------X--------------v
-----XX---------------------------------------------?--------XX---XX------------?----XXX-XXXX----XX?--X-B---------XXXX---X-XX----------XXXX-------M-------------------------------------XX---------X---f
-----XXX----------------------------------------o------------XXX-XXX-----------------XXXXXXXX????XXX--XX---------XXXXX----XXX----------XXXXX--------------------------------------------XXX-----BBXXBBBf
-----XXXX--------------------------------------------X-------XXXXXXXX---------X------XXXXXXXX----XXXX-XXX-------XXXXXX---XXXX----------XXXXXX-------------------------------------------XXXX-----XXX---f
-----XXXXX-------------?---------------------XXXXXXXXX-------XXXXXXXX---------XX-----XXXXXXXX----XXXXXXXXX-----XXXXXXX--XXXXX--XB------XXXXXXX----X------------------------------------oXXXXX---XXXX---f
-----XXXXXX------------------------------T---------XXX----T--XXXXXXXX-TT--X--TTXXT---XTXXXXXX--TTXXXXXXXXXT-TTXTXTXTXT-XXXXXX-TX----T-MXTXXXXXX--XX-------------------------------------XXXXXT-XXXXX-X-f
-----XXXXXXX-----------------------------|--------XXXX----|--XXXXXXXX-||-----||XX|--XX|XXXXXX--||XXXXXXXXX|X||X|X|X|X|XXXXXXXX|X----|--X|XXXXXXXXXX-------------------------------------XXXXX|XXXXXX---f
m----XXXXXXXX----------------------------|-------XXXXX----|-XXXXXXXXX-||---EX||XX|XXXX|XXXXXXX-||XXXXXXXXX|X||X|X|X|X|XXXXXXXX|X----|XXX|XXXXXXXXXX-------------------------------------XXXXX|XXXXXX---X
XXXXXXXXXXXXXXXXXXXXXXXXXXXXXXXXXXXXXXXXX|XXXXXXXXXXXXXXXX|XXXXXXXXXXX||XXXXX||XX|XXXX|XXXXXXXX||XXXXXXXXX|X||X|X|X|X|XXXXXXXX|XXXXX|XXX|XXXXXXXXXXXXXXXXXXXXXXXXXXXXXXXXXXXXXXXXXXXXXXXXXXXX|XXXXXXXXXX
