------M-------------------------------------------B-------------------------------------------------?---------------------------------------------------------------------------------------------------
------------------------------------------------------o-------------------o-------o---------------------------------------------------------------------------------------------------------------------
------------BBBB--------------------------B----------B------o----------------------M------M------------------o-----------------------------------------------------------------M---o--------------------
------------------BBBBBBB-----------------------o----------------------------------------M--------------------------------------------------------------------------------------------------------------
------------------------------------------MBBBX---X-XXXXXXXXXXXX--------------------------------------------------------------------------------------------------------o-------------------------------
---XBoB-X-?--------------------------------------XX-o-----XX--XXXXXo-M---------o-o----------------------------------------------------------------------------------------------------------------------
---XX?--XXX----XB-----------------------------MMXXX------XXX-XXX---Xo----MX--------------------------------------X--------------------------------------------------------------------------------------
---XXX--XXXX--XXBBBBBBBB----------------?????--XXXXXX--XXXXXXXXX---XX---X-XX--?----------------------------------XX-M----------?-----------------------------------------------------------------------v
---XXXX?XXXXXXXX------------------------------XXXXX---XXXXXXXXXX---XXX-XX-XXX?XXXXXXXX-?--------X----------------XXX------X----------------------------------------------------------------------------f
---XXXXXXXXXXXXX-----------------------------XXXXXX--XXXXXXXXXXXBB-XXXXXX-XXXX-XBBBBBB---X-----XX------XXXXX-----XXXX-----XX---------------------------------------------------------------------------f
---XXXXXXXXXXXXX---------?------------------XXXXXXX-XXXXXXXXXXXX---XXXXXX-XXXXXXX--------XX---XXX----------------XXXXX----XXX----------BBBB---------X--------------------------------------------------f
---XXXXXXXXXXXXXX--------------------------XXXXXXXXXXXXXXXXXXXXXX--XXXXXX-XXXXXXXX-----B-XXX-XXXX----------------XXXXXX---XXXX---------------B-----XX--------------------------------------------------f
---XTXXXXXXTXXXXXX----T---X---------------XTXXXXXXTXTXXXXXTXXTTXXX-XXTXXXXXXXXTTXXX-T-T--XTXXXXXX-----T------T---XXXXXXX--XXXXX-------------------XXX--------------------------------T-----------------f
---X|XXXXXX|XXXXXXX---|XXXX--------------XX|XXXXXX|X|XXXXX|XX||XXXXXX|XXXXXXXX||XXXX|-|--X|XXXXXX-----|----o-|---XXXXXXXX-XXXXXX-----------------XXXX--------------------------------|------M----------f
m--X|XXXXXX|XXXXXXXXBB|B-E--------------XXX|XXXXXX|X|XXXXX|XX||XXXXXX|XXXXXXXX||XXXX|E|X-X|XXXXXX-----|------|-E-XXXXXXXXXXXXXXXXE--------------XXXXX--------------------------------|----------E------X
XXXX|XXXXXX|XXXXXXXXXX|----X-------XXXXXXXX|XXXXXX|X|XXXXX|XX||XXXXXX|XXXXXXXX||XXXX|X|XXX|XXXXXX-----|------|--XXXXXXXXXXXXXXXXXXXXXXXXXXXXXXXXXXXXXXXXXXXXXXXXXXXXXXXXXXXXXXXXXXXXX|XXXXXXBXXXXXXXXXXX
