---------------------------------------------------------------------?-------------------------------------------?---------------------------------XX-oXXXXXX---------------------B---------------------
--------------------------------------------------------------------------------------------------------M------------------------------------o--------------------------------------o----?--?--o--------
----------------------------------------------------------------------------------------------------------------------------------------------------BBB----------??????---------------???---------------
------------------------------------------------------------------------------------------------------------------------------------------------------------------------???????---------------------B---
-------------------------------------------------------------------------------------------------------------X------------------------------------------------X-------BBB-------BX-------?X----X------X-
---------------------------------------------------------o--------------------------------------------X--B--XX-----------------------------X---?-------------XX-----X-XX--X-BBBBXXX-X-XX-XXX--XX-----XX-
-----------------------------------------------------------------------------------------------MX-----XX---XXX-----------------------------XX---------------XXX----XXXXX-XXX---XXXX-XXXXXXXXXXXX?X--XXX-
-----------------------------------------------------------------------------------------------------BXXX-XXXX-----------------------------XXX----BBBBBBBBBXXXX-XXXXXXXXXXXXX?XXXXX-XXXXXXXXXXXXXX-XXXXv
------------------------------------------------------------------------------------------------------XXXXXXXX----BBBBBBBB-----------------XXXX?------ooXXXXXXX--XXXXXXXXXXXXXXXXXXXXXXXXXXXXXXXXXXXXXXf
-------------------------------------------------------------------X----------------------------X-----XXXXXXXX-X---------------------------XXXXX---------XXXXXX-XXXXXXXXXXXXXXXXXXXXXXXXXXXXXXXXXXXXXXXf
------------------------------------------------------------------------X---------------X----B-----X--XXXXXXXXX----------------------------XXXXXXXXXXX--XXXXXXXXXXXXXXXXXXXXXXXXXXXXXXXXXXXXXXXXXXXXXXXf
--------X-----------------------------------------------------------------------XXXXXX--XX-------o-o--XXXXXXXXXX---------------------------XXXXXXX?----XXXXXXXXXXXXXXXXXXXXXXXXXXXXXXXXXXXXXXXXXXXXXXXXf
------------------------------------------------------------------T------T------T----T--XXX--T------BXXXXXXXXXXTX--------------------------XXXTXXXTTT-XXXXXXXXXXTTXXXTTTXXXXXXXTXXXXTXXXXTTXXXXXTTXXTXXf
------------------------------------------------------------------|------|------|----|--XXXX-|------XXXXXXXXXXX|XX-------------------------XXX|XXX|||XXXXXXXXXXX||XXX|||XXXXXXX|XXXX|XXXX||XXXXX||XX|XXf
m----o-E--------------------------------------X-------E-----------|--E---|??----|----|--XXXXX|-E---XXXXXXXXXXXX|XXXE----------------------XXXX|XXX|||XXXXXXXXXXX||XXX|||XXXXXXX|XXXX|XXXX||XXXXX||XX|XXX
XXX--------XXXXXXXXXXXXXXXXXXXXXXXXXXXXXXXXXXXXXXXXXXXXXXX-X---XXX|-----X|XXXXXX|XXX-|--XXXXX|----XXXXXXXXXXXXX|XXXXXXXXXXXXXXXXXXXXXXXXXXXXXX|XXX|||XXXXXXXXXXX||XXX|||XXXXXXX|XXXX|XXXX||XXXXX||XX|XXX
