-------------------------M------------------------------------BBBBBBBB----BBBBBBB-------------------------------------------------------------------------------------------------------------o---------
----------------------------------o---------------------------------------------X--------------------------------------------------------------------------------------------?????-----??????-----------
----------------------------------------------------------------------------X-----------------------------------------------------------------------------o--------o---------------X-----------XXXXXX-o-
----------o---------------------------------------------------------o--------------------------------------------------------------------------------------------------------------T-----M---T-------T--
---------------------------------------------------------------oM--------------------?--------------------------------------------------------------------------------------------T|------Xo-|---XXXX|--
----------------------------------------------T----------------------T--BBBB-----------------------------------------------------------------------------T-------?------X---------||X-o-----X|----XXX|X-
----------------------------------------------|-----X----------------|--------------X-X------------------------------------------------------------------|---------------B--------||X-------X|?------|X-
----------------------------------------------|-----XX---------------|-------------XXXX------------------------------------------------------------M---T-|--------X-------------T-||X-------X|X-----X|Xv
----------X----------------------------o------|-----XXX--------------|------------XXXXX----------------------------------------------------------------|-|-------XX--------XXXXX|X||XM------X|XX---XX|Xf
----------XX----------------------------------|-----XXXX-------------|-----------XXXXXX----------------------------------------------------------------|B|BB----XXX-------XX-TBB|X||X-------X|XXX-XXX|Xf
----------XXX----------------T-------X--------|-----XXXXX----XXXXX---|----------XXXXXXX----------------------------------------------------------------|-|-----XXXX----T-XXX-|?X|X||X------TX|XXXXXXX|Xf
----------XXXX---------------|--T----XX-------|-----XXXXXX-----------|---------XXXXXXXX------B--------------------------------------------------------?|-|----XXXXX----|XXXX-|XX|X||XT-----|X|XXXXXXX|Xf
----------XXXXX--------------|BB|BBB-XXX------|--X-?XXXXXXX---X------|--------XXXXXXXXX------o---------------------------------------------------------|-|---XXXXXX----|XXXX?|XX|X||X|-----|X|XXXXXXX|Tf
----------XXXXXX-------------|--|o---XXXX--M--|XXXX-XXXXXXXX-XX------|-------XXXXXXXXXX----------------------------------------------------------------|-|--XXXXXXX---X|XXXXX|XX|X||X|----o|X|XXXXXXX||f
m---------XXXXXXX--E----EE---|--|E---XXXXX-BE-|--XXXXXXXXXXXXXX----EE|--E---XXXXXXXXXXX------E-----------------------------------------E---------------|-|-XXXXXXXX-XXX|XXXXX|XX|X||X|-X--E|X|XXXXXXX||X
XXXXXXXXXXXXXXXXXX--XBBXXXXXX|XX|XXXXXXXXXXXXX|XXXXXXXXXXXXXXXX---XXX|XXXXXXXXXXXXXXXXX--B--XXXXXXXXXXXXXXXXXXXXXXXXXXXXXXXXXXXXXXXXXXXXXXXXXXXXXXX----|X|XXXXXXXXXoXXX|XXXXX|XX|X||X|XX-XX|X|XXXXXXX||X
