-----------------------------------X---------------------------------------------------------------------------------------------------------------------E-------------------------------E--------------
-----------------------------------------------E--------------------------------------------------------------------------------------------------------------------------------------------------------
-----------------------------------------------------------------------E------------------------------------------------------------------------------------------------------------T-------------------
---------------------------------------------E--------------------------------------------X----------------------------------------------------------------------------T--------------------------------
-------------------|------------------------X----------------------------------------------------------------------------------X-------------------|-T--------------------------------------------------
---------------------------------------------------------------E-----------------------------------------------------------------|----------------------------------------------------------------------
----------------------------------------------------------------------------------------------------------------------X--------------------X----------------------------T-------------------------------
--------------------------------------------------------------------------T-----------------------------------------------------------------------------------E----------------------------------------v
-------------------------------------T-|-----------------------------------------------------------------------------------------------------------------------------------o---------------------------f
--------------------------------------------------------------------------------------------------------------------T---|----E-------------------------------------------------------------------------f
-TE---E------------------------------------------------------------------------------------------------------------------------------------------------------------------------------------------------f
-------------------------------------X--------------------------------------------------o-------------------X-------------------------------------X-----X----------------------------------------------f
-------------X------------------------------------------------|--------------------------------------------E-----------------------E-------------------X-----------------------------------------------f
--------------------------------------------------------------------------------------------------------------E-------------------------------------------------------------o-----o------------T-------f
m------------------------------------------------------------------------------------------------------------------------------------------------------------------------------------------------------X
XXXXXXXXXXXXXXXXXXXXXXXXXXXXXXXXXXXXXXXXXXXXXXXXXXXXXXXXXXXXXXXXXXXXXXXXXXXXXXXXXXXXXXXXXXXXXXXXXXXXXXXXXXXXXXXXXXXXXXXXXXXXXXXXXXXXXXXXXXXXXXXXXXXXXXXXXXXXXXXXXXXXXXXXXXXXXXXXXXXXXXXXXXXXXXXXXXXXXXXX
