---------------------------------------------------------------B----------------------------------------M--M--------------------X-----------------------------------------------------------------------
-----------------------------------------------------------------------------------------------------------------------------------------M-----------------o----------o-MBBBB----------------------??---
--------------------------------------------------------------------------------------------------------------------------------------------------------------------B----------BBBB--------------o------
-------------------------------------------------------------------------------o------------------------------------------------------X--?---------------------------?????--------------------------oo--
--------------------------------------------------------------------------------------------------------X--------------------------B-------------------X------------????????X---------------------------
----------------------------------------------------------------------------------------X--------------XX-----X---------------------------------------XX-------------------XX------X----BBBXXXXXX-XX----
------------------------------------------------------------------------X---------BB--------------X---XXX------------------X------X------------------XXX-----------X------XXX-o----XX----X----XXXXXXX---
---X-----------------X--------------------------------------------------XX--------------X---X----XX--XXXX----BBB?BBBX-------X-----XXB-----------X---XXXX------o----XX----XXXX---XXMXXX---X-o--XXXXXXXX-v
---XX---------------XX-----o--------------------------------------------XXX------------XX---XX--XXX-XXXXX----------XX-------XX----XXX----------XX--XXXXX-----------XXXX-XXXXX-o----XXXX--XX---XXXXXXXXXf
---XXX-------------XXX--------------------------------------------------XXXX--M-------XXX---XXXXXXXXXXXXXX--------XXX------oXXX---XXXX-X------XXX-XXXXXX-----------XXXXXXXXXX------XXXXX-XXX--XXXXXXXXXf
---XXXX-----------XXXX--------?-----------------------------------------XXXXX--XXXXX-XXXX---XXXXXXXXXXXXXXXX---X-XXXX--XX---XXXXX-XXXXXXX----XXXXXXXXXXX--------XXXXXXXXXXXXX----XXXXXXXXXXXX-XXXXXXXXXf
---XXXXX---------XXXXX-------------------------------------------XXXXXXXXXXXXX------XXXXX--BXXXXXXXXXXXXXXXX---XXXXXX-X-----XXXXXXXXXXXXXX-oXXXXXXXXXXXX-----------XXXXXXXXXX------XXXXXXXXXXXXXXXXXXXXf
---XXXXXX-------XXXXXX----------------B-----------T--------------T--T---XXXXXXX----XTXXXX-BBXXXXXXXXXTXTXXXXX--TXXTXXTX----TXXXTXXXXXXTXXTXXXXXXXXXXXXXX-------T-TXXXXXXXXXXX--TT--TXXTXXXTTXXXXTXXXXXXf
---XXXXXXX-----XXXXXXX----------------------------|--------------|--|---XXXXXXXX--XX|XXXX--XXXXXXXXXX|X|XXXXXXX|XX|XX|X-X--|XXX|XXXXXX|XX|XXXXXXXXXXXXXX-------|-|XXXXXXXXXXX--||--|XX|XXX||XXXX|XXXXXXf
m--XXXXXXXX---XXXXXXXX--------EE------------------|--E-----------|--|---XXXXXXXXXXXX|XXXXEXXXXXXXXXXX|X|XXXXXXX|XX|XX|X-E--|XXX|XXXXXX|XX|XXXXXXXXXXXXXX---Mo-E|X|XXXXXXXXXXX--||E-|XX|XXX||XXXX|XXXXXXX
XXXXXXXXXXXXXXXXXXXXXXXXXXXXXXXXXXXXXXXXXXXXXXXXXX|XXXXXX-XXXXXXX|XX|-o-XXXXXXXXXXXX|XXXXXXXXXXXXXXXX|X|XXXXXXX|XX|XX|X----|XXX|XXXXXX|XX|XXXXXXXXXXXXXXXXXXXXX|X|XXXXXXXXXXX--||?-|XX|XXX||XXXX|XXXXXXX
