---------------------------------------------------------------------------------------------------------o----------------------------------------------------------------------------------------------
--------------------------------------------------------------------------------------------------------------------------------------------------------------------------------------------------------
-------XXX----------------------------------------------------------------------------------------------------------------------------------------------------------------------------------------------
-----?------XXXXXXX-------------------------------------------------------------------------------------------------------------------------------------------------------------------------------------
-------?------------------------------------------------------------------------------------------------------------------------------------------------------------------------------------------------
-----------X-----------X---------------------------------------o----------------------------------------------------------------------------------------------------------------------------------------
---X--X----XX---------XX---------------------------------------------------------------------------------X----------------------------------------------------------------------------------------------
---XX-XX---XXX-------XXX---------------------------------------------------------------------------------XX----XXXXXX----M-----------------------------------------------------------------------------v
---XXXXXX--XXXX-----XXXX----------------------------------------------------------------?---------------XXXX------------------------------------------------o------------------------------------------f
---XXXXXXX-XXXXX---XXXXX-------------------------------------------X-----------------------------------XXXXXX------------------X-----------------------------------------------------------------------f
---XXXXXXXXXXXXXX-XXXXXX----------------------------------------M-------------------------------------XXXXXXXX--X-------------XX--------X---X----------------------------X-----------------------------f
---XXXXXXXXXXXXXXXXXXXXX------------------------------------------------------------X----------------XXXXXXXXXX-XX????---?---XXX-----------------------------------------------------------------------f
---XXXXXXXXTXTXXXXXXXXXX----------------------------------------T------T------------XX--------------XXXXXXXXXTXXXXX---------XXXX---TT----------????????-------------------------------------T----------f
---XXXXXXXX|X|XXXXXXXXXX----------------------------------------|------|-----B------XXX------------XXXXXXXXXX|XXXXXX-------XXXXXo--||-------------------------------------------------------|----------f
m--XXXXXXXX|X|XXXXXXXXXX----------------------------------------|------|------------XXXX----------XXXXXXXXXXX|XXXXXXX-----XXXXXX---||-----------E-------------------------------------------|----------X
XXXXXXXXXXX|X|XXXXXXXXXXXXXXXXXXXXXXXXXXXXXXXXXXXXXXXXXXXXXXXXX-|-XXXXX|XXXX-------XXXXXXXXXXXXXXXXXXXXXXXXXX|XXXXXXXXXXXXXXXXXXXXX||XXXXXXXXXXXXXXXXXXXXXXXXXXXXXXXXXXXXXXXXXXXXXXXXXXXXXXX|XXXXXXXXXXX
