-------------------------M------------------------------------BBBBBBBB----BBBBBBB------------------------------------------------------------------------------?---------------------------o--o---------
----------------------------------o---------------------------------------------X---------------------------------------------------------------------XX?XXXX-------X------o-?????-M---??????-----------
----------------------------------------------------------------------------X----------?----------------------------------------------------------------M-o------ooo---------------X-----------XXXXXX-o-
----------o---------------------------------------------------------o--------M-----------------------------------------------------------------------------------------o-o-------X-T-----M---T-----o-T--
---------------------------------------------------------------oM--------------------?--------------------------------------------------------------------------------------------T|--XB--Xo-|---XX?X|--
----------------------------------------------T----------------------T--BBBB---------------B-------------------------------------------------------------T-------?------X---------||XXX---X-X|---BXXX|X-
----------------------------------------------|-----X----------------|----------------X------------------------------------------------------------------|---------------B--------||XXXT--XXX|?------|X-
----------------------------------------------|-----XX---------------|---------------XX------------------------------------------------------------M---T-|-------XX----------T--T-||XXX|--XXX|X-----X|Xv
----------X----------------------------o------|-----XXX--------------|----------?---XXX----X-----------------------------------------------------------|-|------XXX---?????XX|XX|X||XXX|--XXX|XXX--XX|Xf
----------XX----------------------------------|-----XXXX-------------|--------X----XXXX----XX----------------------------------------------------------|B|BB---XXXXX----??XX-|BB|X||XXX|--XXX|XXX-XXX|Xf
----------XXX----------------T----------------|-----XXXXX----XXXXX---|--------XX--XXXXX-B--XXX---------------------------------------------------------|-|-o--XXXXXXX--T-XXX-|?X|X||XXX|X-XTX|XXXXXXX|Xf
----------XXXX---------------|--T-------------|-----XXXXXX-----------|--------XXXXXXXXX---XXXXX-------------------------------------------------------?|-|---XXXXXXXXX-|XXXX-|XX|X||XTX|XXX|X|XXXXXXX|Xf
----------XXXXX--------------|BB|BBB----------|--X-?XXXXXXX---X------|--------XXXXXXXXX--XXXXXXX-------------------------------------------------------|-|--XXXXXXXXXXX|XXXX?|XX|X||X|X|XXX|X|XXXXXXX|Tf
----------XXXXXX-------------|--|o---------M--|XXXX-XXXXXXXX-XX------|--------XXXXXXXXX-XXXXXXXXX-----------------------------------------------------T|-|-XXXXXXXXXXXT|XTXXX|XX|T||X|X|XXX|X|XXXXXXX||f
m---------XXXXXXX--E----EE---|--|E---------BE-|--XXXXXXXXXXXXXX----EE|--E-----XXXXXXXXXXXXXXXXXXXX-------------------------------------E---E?????o?E--||-|XXXXXXXXXXXX||X|XXX|XX||||X|X|XXX|X|XXXXXXX||X
XXXXXXXXXXXXXXXXXX--XBBXXXXXX|XX|XXXXXXMXXXXXX|XXXXXXXXXXXXXXXX---XXX|X-----XXXXXXXXXXXXXXXXXXXXXXXXXXXXXXXXXXXXXXXXXXXXXXXXXXXXXXXXXXX-XXXXXX--XXX---||-|XXXXXXXXXXXX||X|XXX|XX||||X|X|XXX|X|XXXXXXX||X
