---------------------------------------------------------------------------------------------?--??????--------------------------------------------------------------------------------------------------
-------------------------------------------------------------------------------------------------------------------------------------------------------------------------------------------????????-----
---------------------------------------------------------------------------------------------------------------------?-?-?------X----------------------------------------------------X-----XXXXXXXX-----
------------------------------------------------------------------------------------------?-------------X--------BBBB--XXXXXXX------------------------------------------------BBBBBB--------------------
--------------------------------------------------------------------------------------------------------------------?-BBBB-------X----------------------------------------------------X?---BBB----------
------------------------------------------------------M---------------o----------X-X--------X----------B-------------X------------X--------------------------------------------------XX------------?----
------------------------------------------------------------------------M------------X-----XX--?-------------o------XX-XXX---?---XX-------------------------------------------------XXX--XXXXXXXX-------
-----X---------------------------------------------------o---X-----X-----------------XX---XXXB---X---------?-------XXX---X--XX--XXX-------------------------------------XX---------XXXX-X--------------v
-----XX---------------------------------------------?--------XX---XX------------M----XXX-XXXX----XX?--X-B-oo------XXXX-----XX--XXXX-----------------------------------------------XXXXXBXXB--------X---f
-----XXX-----------------------------------------------------XXX-XXX-----------------XXXXXXXX????XXX--XX------M--XXXXX----XXX-XXXXX-----X------------------------------------?---XXXXXX-XXX----X?BXXB??f
-----XXXX--------------------------------------------X-------XXXXXXXX---------X------XXXXXXXX----XXXX-XXX------?XXXXXX---XXXXXXXXXXX--X---------------------------X-------------XXXXXXX-XXXX--XXXXXX---f
-----XXXXX-------------?---------------------XXXXXXXXX-------XXXXXXXX---------XX-----XXXXXXXX----XXXXXXXXX-----XXXXXXX--XXXXXXXXXXXXXXX---------------------------XX-----------XXXXXXXXoXXXXXXXXXXXX---f
-----XXXXXX------------------------------T---------XXX----T--XXXXXXXX-MT--X--TTXXT---XTXXXTXX--TTXXXXXXXXXT-TTXXXTXTTT-XXTXXXXTXXXXXXXX--X------------------------XXX-----T---XXXXXXXXT-XTXXTTXXXXXX-X-f
-----XXXXXXX-----------------------------|--------XXXX----|--XXXXXXXX--|-----||XX|--XX|XXX|XX--||XXXXXXXXX|X||XXX|X|||XXX|XXXX|XXXXXXXX-XX------------------------XXXX----|--XXXXXXXXX|-X|XX||XXXXXXo--f
m----XXXXXXXX----------------------------|-------XXXXX----|-XXXXXXXXX--|---EX||XX|XXXX|XXX|XXX-||XXXXXXXXX|X||XXX|X|||XXX|XXXX|XXXXXXXXXXX----X-------------------XXXXX---|-XXXXXXXXXX|-X|XX||XXXXXXX--X
XXXXXXXXXXXXXXXXXXXXXXXXXXXXXXXXXXXXXXXXX|XXXXXXXXXXXXXXXX|XXXXXXXXXXXX|-XXXX||XX|XXXX|XXX|XXXX||XXXXXXXXX|X||XXX|X|||XXX|XXXX|XXXXXXXXXXXXXXXXXXXXXXXXXXXXXXXXXXXXXXXXX--|XXXXXXXXXXX|-X|XX||XXXXXXXX-X
