------M-----------o-------------------------------B-------------------------------------------------?---------------------------------------------------------------------------------------------------
------------------------------------------------------o-------------------o-------o---------------------------------------------------------------------------------------------------------------------
-----------XBBBBXX------------------------B----------B------o----------------------M------M------------------o-----------------------------------------------------------------M---o--------------------
-------------------XX---------------------------o----------------------------------------M--------------------------------------------------------------------------------------------------------------
------------------------------------------MBBBX--X--XXXXXXXXXXXX--X-----------------------------------------------------------------------------------------------------o-------------------------------
---XBoB-X-?-------------------------------------XX--o-----XX--XXXXXo-M---------o-o----------------------------------------------------------------------------------------------------------------------
---XX?--XXX----XB--BBB--o---BBBBB-------------MXXX-------XXX-XXXXXXXo----MX--------------------------------------X--------------------------------------------------------------------------------------
---XXX--XXXX--XXBBBBBB?B----------------?????-XXXX-XX--XXXXXXXXXXXXXX---X-XX--?----------------------------------XX-M----------?-----------------------------------------------------------------------v
---XXXX?XXXXXXXX-----------X-----------X-----XXXXX----XXXXXXXXXXXXXXXX-XX-XXX?XXXXXXXXX?--------X----------------XXX------X----------------------------------------------------------------------------f
---XXXXXXXXXXXXX---B-------XX---------XX----XXXXXX---XXXXXXXXXXXXXXXXXXXX-XXXX-XBBBBBXX--X-----XX------XXXXX-----XXXX-----XX---------------------------------------------------------------------------f
---XXXXXXXXXXXXX---------?-XXX-------XXX---XXXXXXX--XXXXXXXXXXXXXXXXXXXXX-XXXXXXX---XXX--XX---XXX----------------XXXXX----XXX----------BBBB---------X--------------------------------------------------f
---XXXXXXXXXXXXXX------o---XXXX-----XXXX--XXXXXXXX-XXXXXXXXXXXXXXXXXXXXXX-XXXXXXXX-XXXXB-XXX-XXXX----------------XXXXXX---XXXX---------------B-----XX--------------------------------------------------f
---XTXXXXXXTXTXTXX---TT---XXXXXX---XXXXX-XXTXXXXXXTXTXXXXXTXXTTXXXXXXTXXXXXXXXTTXXXXTXT--XTXXXXXX-----T------T---XXXXXXX--XXXXX-------------------XXX--------------------------------T-----------------f
---X|XXXXXX|X|X|XXX--||XXXXXXXXXX-XXXXXXXXX|XXXXXX|X|XXXXX|XX||XXXXXX|XXXXXXXX||XXXX|X|--X|XXXXXX-----|----o-|---XXXXXXXX-XXXXXX-----------------XXXX--------------------------------|------M----------f
m--X|XXXXXX|X|X|XXXXB||BEE-XXXXXXXXXXXXXXXX|XXXXXX|X|XXXXX|XX||XXXXXX|XXXXXXXX||XXXX|X|X-X|XXXXXX-----|------|-E-XXXXXXXXXXXXXXXXE--------------XXXXX--------------------------------|----------E------X
XXXX|XXXXXX|X|X|XXXXX||----XXXXXXXXXXXXXXXX|XXXXXX|X|XXXXX|XX||XXXXXX|XXXXXXXX||XXXX|X|XXX|XXXXXX-----|------|--XXXXXXXXXXXXXXXXXXXXXXXXXXXXXXXXXXXXXXXXXXXXXXXXXXXXXXXXXXXXXXXXXXXXX|XXXXXXBXXXXXXXXXXX
