---------------------------------------------------------------------------------------------o-------------------------------------------------------------------M-----------X----------o------?-oo-----
----------------------------------------------------------------------------------------------------------------------M-------------------------------------------------oX----XMXXXXX---------------?---
--------------------------------------------------------------------------------------------------------------M------------------------------------------------------o-----BBBBB---------o-------BBBXXX-
-----------------------------------------------------------------------------------------------------------M------------------------------------------------------o----------????---------XXBXXXX----o--
-------------------------------------------------------------------------------------------------------o---------------------------------------------------------------BBXB---o----------------o?----X--
---------------------------------------------------------------------------------------------------------------------------M-----------------------------------X-M????--XX------X-------X------X-o-XXX--
-------------------------------------------------------------------------M-------------------------------------------------------------------------------------XX------XXXX----XX---XXXXXXXX--XX--XXXXX-
----------------------------------------------------------------------------------------------X----------o-X-------------------------------------------------B-XXX--?-XXXXXXXXXXXXX---XXX----XXX-XXXXXXv
---------------------------------------------------------------------------------------------XX--X-----M--XX-------------X-------------------------------------XXXX--XXXXXXXXXXXX----XXXX-B-XXXXXXXXXXXf
---X--------------------------------------------------------------M-------------------------XXX-XX-------XXX-------------XX------------------------------------XXXXXXXXXXXXXXXXXX---XXXXX--XXXXXXXXXXXXf
---XX----------------------------------------------------------------M---------------------XXXXXXX------XXXX?------------XXX------------------------------???--XXXXXXXXXXXXXXXXXX--XXXXXX-XXXXXXXXXXXXXf
---XXX------------------------------------------------------------------------------------XXXXXXXX-----XXXXX-------------XXXX----------------------------------XXXXXXXXXXXXXXXXXX-XXXXXXXXXXXXXXXXXXXXXf
---XXXX----------------------------------------------------------------TT--------TT----T-XXXXXXTXXT---XXTXXX-------------XXXXX-----------------------------TT--XTXXTXXXTTXXXXTXXTTTXXXTXXXXXXXXXXXTXTXXf
---XXXXX---------------------------------------------------------------||--------||-XXX|XXXXXXX|XX|--XXX|XXX-------------XXXXXX----------------------------||--X|XX|XXX||XXXX|XX|||XXX|XXXXXXXXXXX|X|XXf
m--XXXXXX---------------------------------------------------E-E--------||--------||----|XXXXXXX|XX|XXXXX|XXX-------------XXXXXXX---------------------------||--X|XX|XXX||XXXX|XX|||XXX|XXXXXXXXXXX|X|XXX
XXXXXXXXXXXXXXXXXXXXXXXXXXXXXXXXXXXXXXXXXXXXXXXXXXXXXXXXXXXXXXXXXXXXXXX||XXXXXXXX||XXXX|XXXXXXX|XX|XXXXX|XXX----XoXXXXX--XXXXXXXXXXXXXXXXXXXXXXXXXXXXXXXXXX||XXX|XX|XXX||XXXX|XX|||XXX|XXXXXXXXXXX|X|XXX
