--------------------------------------------------------------------------------------------------------------------------------------------------------------------------------------------------------
--------------------------------------------------------------------------------------------------------------------------------------------------------------------------------------------------------
-----------------------------------------------------------------------------------o--------------------------------------------------------------------------------------------------------?-----------
--------------------------------------------------------------------------------------------------------------------------------------------------------------------------------------------B-----------
--------------------------------------------------------------------------------------------------------------------------------------------------------------------------------------------------------
-------o-------------------------------------------------------------------------------------------------------------------------------------------------------------------------------------------M----
-----------------------------------------------------------------------------------------------------------------X----------------------------------------------------------------------------X-------X-
---------------------------------------------------------------------------------------------------------------------------------------------------------------------------------------------XX-------Xv
--------------------------------------------------------------------------------------------------------------------------------------------------------------------------------------------XXX-------Xf
------------------------------------------------X--------------------------------------XX--------------------------------------------------------------------------------------------------XXXX-------Xf
-----------------------------------------------XX-----------------------X-----------------------------------------------------------------------------------------------------------------XXXXX-------Xf
----------------------------------------------XXX-------?--------------------------------------------------------------------------------------------------------------------------------XXXXXX-------Xf
---------------------------------------------XXXX---------------------------------T--------------?--------------------------------------------------------------------------------------XXXXXXX----TTTXf
--------------------------------------------XXXXX---------------------------------|----------------------------------------------------------------------------------------------------XXXXXXXX----|||Xf
m------------------------------------------XXXXXX-------------------------------E-|-------------------E--------------------------------------------------------------------------E----XXXXXXXXX----|||XX
XXXX----------XXXXXXXXXXXXXXXXXXXXXXXXXXXXXXXXXXXXXXXXXX-----XXXXXXXXXXXXXXXXXXXXX|XXXXXXXXXXXX---XXXXXXXXXXXXXXXXXXXXXXXXXXXXXXXXXXXXXXXXXXXXXXXXXXXXXXXXXXXXXXXXXXXXXXXXXXXXXXXXX--XXXXXXXXXXXXXX|||XX
