-----------------------------------X------------------------------|-------------------------------------------------------------------------------------------------------------------------------------
------------------|------------------------------------------------------------------------------------------------------------T----------------|-----o-------------------------------------------------
-----------------X-----------------------------------------------------E----------T------------------------------------------------------------------------T---X-----------------------T----------------
-------------------------------------------------------------|-----------------------------------------------------------|-------------------------------------------------o----------------------------
-------------------------------------------------------------------------------------------------------------------------------------------------------------------------o------------------------------
---------------------------------------------------------------------------------------------------------------------------------|-|--------------------------------------------------------------------
--|----------------------------------------------------------------------------------------------------------------------------------------X---------------------------------------------o--------------
--------------------------------------------------------------------------------------------------------------------------------------------------------------E----------------------------------------v
------------------------------------------T------------------------------------------------------------------------------------------------------------------------------------------------------------f
---T------------------------------------------o--------|--------------------------T-------------------------------------------------------------------------------------------------X------------------f
-T-----X-----------------------------------------------------------------------------------------------------------------------------------------------------------------------------------------------f
------------------------------------------------------------------------------------------------------------X------------------------------------------------------------------------------------------f
-------------X--------------------------------E---------------|--------------------------|----------------------------------------------------------------------------------------------------------E--f
------------------------------------------o--------------------------------o------------------------------------------------------------------------------------------------------o------------T-------f
m------------------------------------------------------------------------------------------------------------------------------------------------------------------------------------------------------X
XXXXXXXXXXXXXXXXXXXXXXXXXXXXXXXXXXXXXXXXXXXXXXXXXXXXXXXXXXXXXXXXXXXXXXXXXXXXXXXXXXXXXXXXXXXXXXXXXXXXXXXXXXXXXXXXXXXXXXXXXXXXXXXXXXXXXXXXXXXXXXXXXXXXXXXXXXXXXXXXXXXXXXXXXXXXXXXXXXXXXXXXXXXXXXXXXXXXXXXX
