---------------------------------------------------------------------------------------------------------o----------------------------------------------------------------------------------------------
--------------------------------------------------------------------------------------------?-----------------------------------------------------------------------------------------------------------
--------------------------------------------------------------------------------------------------------------------------------------------------------------------------------------------------------
------------------------------------------------------------------------o-------------------------------------------------------------------------------------------------------------------------------
----------------------------------------?------------------------------------------X-------o------------------------------------------------------------------------------------------------------------
---------------------------------------------------------------o----o??-----------XX--------------------------------------------------------------------------------------------------------------------
--------------------------------------------------------------------------M------XXX--------------X------X-----o----------------------------------------------------------------------------------------
--------------------------------------------------X-----------------------------XXXX-------------XX------XX----XXXXXX----M-----------------------------------------------------------------------------v
-------------------------------------------------oXX---------------------------XXXXX----?-------XXX-----XXXX------------------------------------------------o------------------------------------------f
--------------------------------------------------XXX--------------X-XXXXX----XXXXXX-----------XXXX----XXXXXX------------------X-----------------------------------------------------------------------f
-------------------------------------B------------XXXX----------M------------XXXXXXX----------XXXXX---XXXXXXXX--X-------------XX--------X---X----------------------------X-----------------------------f
--------------------------------------------------XXXXX--???????--BBB-------XXXXXXXXX--------XXXXXX--XXXXXXXXXX-XX????---?---XXX-----------------------------------------------------------------------f
------------------------------------TT------------XXXXXX-T-T----T-----TT?--XXXXXXXXXXX---X--XXXXXXXTXXXXXXXXXTXXXXX---------XXXX---TT----------????????-------------------------------------T----------f
------------------------------------||------------XXXXXXX|-|----|-----||--XXXXXXXXXXXXX-XX-XXXXXXXX|XXXXXXXXX|XXXXXX-------XXXXXo--||-------------------------------------------------------|----------f
m-----------------------------------||------------XXXXXXX|-|-E--|-----||-XXXXXXXXXXXXXXXXXXXXXXXXXX|XXXXXXXXX|XXXXXXX---E-XXXXXX---||-----------E-------------------------------------------|----------X
XXXXXXXXXXXXXXXXXXXXXXXXXXXXXXXXXX--||----XXXXXXXXXXXXXXX|X|XXX-|-----||XXXXXXXXXXXXXXXXXXXXXXXXXXX|XXXXXXXXX|XXXXXXXXXXXXXXXXXXXXX||XXXXXXXXXXXXXXXXXXXXXXXXXXXXXXXXXXXXXXXXXXXXXXXXXXXXXXX|XXXXXXXXXXX
