---------------------------------------------------------------------------------------------o------------------------BBBBB--------------------------------------M-----------X----------o------?-o------
-----------------------------------------------------------------------------------o---------------------------o------MX--M--------------------o------------------------oX----XMXXXXX---------------?---
--------------------------------------------------------------------------------------------------------------M------------------------------------------------------o-----BBBBB---------o-------BBBXXX-
-----------------------------------------------------------------------------------------------------------M--------o-------------o-------------------------------o-----------------------XXBXXXX-------
-------------------------------------------------------------------------------------------------------o----------------------o----------------------------------------BBXB---o----------------------X--
--------------------------------------------------------------------------------------------------------------------------?M--o-------o--------o-----------------M????-XXX------X-------X--------o--XX--
-------------------------------------------------------------------------M---------------------------------X-------------------o--------------------------------------XXXXX----XX---XXXXXXXX-------XXX--
----------------------------------------------------------------------------------------------X------X---o-X----------------------XX--B-----------------------------?XXXXXXXXXXXXXX---XXX------X--XXXX-v
---------------------------------------------------------------------------------------------XX--X---XXMBBXX-------------X-----B-XX---M-----------------------------XXXXXXXXXXXXX----XXXX----X-XXXXXXX-f
---X--------------------------------------------------------------M-------------------------XXX-XX---XXX-XXX-------------XX-B---XXX--------------------------------XXXXXXXXXXXXXX---XXXXX------XXXXXXX-f
---XX----------------------------------------------------------------M---------------------XXXXXXX---XXXXXXX?---------XXXXXX---XXXX-----------------------???-----XXXXXXXXXXXXXXX--XXXXXX------XXXXXXX-f
---XXX------------------------------------------------------------------------------------XXXXXXXX---XXXXXXX-------------XXXX-XXXXX------------------------------XXXXXXXXXXXXXXXX-XXXXXXX-----XXXXXXXX-f
---XXXX----------------------------------------------------------------TT--------TT----T-XXXXXXTXXT--XXXTXXX?-------T----XXXXXXXXXX--TT---TT-X------------------TXXTXXXTXXXXXTXXTTTXXXTXX----XXXXXTXTX-f
---XXXXX---------------------------------------------------------------||--------||-XXX|XXXXXXX|XX|--XXX|XXXX-------|---oXXXXXXXXXX--||---||XX-----------------X|XX|XXX|XXXXX|XX|||XXX|XX---XXXXXX|X|XXf
m--XXXXXX---------------------------------------------------E-E--------||--------||----|XXXXXXX|XX|XXXXX|XXXXX------|----XXXXXXXXXX?-||-E-||XX?---------------XX|XX|XXX|XXXXX|XX|||XXX|XXE-XXXXXXX|X|XXX
XXXXXXXXXXXXXXXXXXXXXXXXXXXXXXXXXXXXXXXXXXXXXXXXXXXXXXXXXXXXXXXXXXXXXXX||XXXXXXXX||XXXX|XXXXXXX|XX|XXXXX|XXXXXX--o-X|X---XXXXXXXXXX--||---||XXXXXXXXXXXXXXXXXXXX|XX|XXX|XXXXX|XX|||XXX|XX-XXXXXXXX|X|XXX
