-------------------------------------------------------------------------------------XXXX------------------------------------------------B?---XXXXXXB------------------------??---------------------o---
-----------------------------------------------------------------------------------------------------------------------------------------------????????--BB---B----------------oBBBB-----------o--------
-----------------------------------------------------------------------------------o-------------------------------------------------------------------------------BXXXXXXXXXXXXXXXXX---------?----M----
--------M------------------------------------------------------------------------------------------------------------------------------------------BBBBBB----------X-----------------------X-T----XXXXX-
--------------------------------------------------------------------------------------------------------------------------------------------T--T----o-o-X-XBXXXMX-Xo???T?X??BBBXTT--BBB?B??-X|XXXXBB-X--
-----T---------------------------------------------------------------X-----------o----------------------------------------------------------|-X|T???---X------X--XX--XX|XX-?-?XX||---------XX|T---X-XXX-
-----|---------------------------------------------------o-----------XX----X----------------------------------------------------------------|TX||---XBTXX---BXXXXXX--XX|XX-?-XXX||---X--X-XTX||--XXXXXX-
-----|X-------X------------------------------------------X-----X-----XXX---XX------X-----------X--------------------------------------------||T||-X-XX|XXT-XXXXXXXX-XXX|TX--XXXX||X--XXXXXX|X||X-XXTXXXv
-----|--------XX-----------------------------------------------XX----XXXX--XXX----TXX---------XX--------------------------------------------|||||TXXXT|TX|XXXXXXXXXXXXX||X-XXXXX||XX-XXXXXX|X||XXXX|XXXf
-----|--------XXX----------------------------------------------XXX---XXXXX-XXXX---|XXX-------XXX--------------------------------------------||||||XXX|||X|XXXXXXXXXXXXX||XXXXXXX||XXXXXXXXX|X||XXXX|XXXf
-----|--------XXXX------o--------------------------------------XXXX--XXXXXXXXXXX--|XXXX-----XXXX--------------------------------------------||||||XXX|||X|XXXXXXXXTXXXX||XXXXXXX||XTXXXXXXX|X||XXXX|XXXf
-----|--------XXXXX--------------------------------------------XXXXX-XXXXXXXXXXXX-|XXXXX---XXXXX---------------------------------------o----||||||XXX|||X|XXXXXXXX|XXXX||XXXXXXX||X|XXXXXXX|X||XXXX|XXXf
-----|--------XXXXXX-------------------------------------------XXXXXXXXXXXXXXXXXXX|XXXXXX-XXXXXX--------------------------------------------||||||XXX|||X|XXXXXXXX|XXXX||XXXTXTX||X|XXXXXTX|X||XXXX|XXXf
-----|--------XXXXXXX------------------------------------------XXXXXXXXXXTXXXXXXXX|XXXXXXXXXXXXX--------------------------------------------||||||XXX|||X|XXXXXXXX|XXXX||XXX|X|X||X|XXXXX|X|T||XXXX|XXXf
m----|--------XXXXXXXX-----------------------------------------XXXXXXXXXX|XXXXXXXX|XXXXXXXXXXXXX------------------------------------------E-||||||XXX|||X|XXXXXXXX|XXXX||XXX|X|X||X|XXXXX|X||||XXXX|XXXX
XXXXX|XXXXXXXXXXXXXXXXXXXXXXXXXXXXXXXXXXXXXXXXXXXXXX-XXXXXX---XXXXXXXXXXX|XXXXXXXX|XXXXXXXXXXXXXXXXXXXXXXXXXXXXXXXXXXXXXXXXXXXXXXXXXXXXXXXXX||||||XXX|||X|XXXXXXXX|XXXX||XXX|X|X||X|XXXXX|X||||XXXX|XXXX
