|?X---M-B--M----X--X--|?X---M-T---T-oTXM|?T--X---oB---o---?----?B-?-BM-E--Mo-M?-|T--BM-MB-|X---?o-BE-B----EB----?-----T-------|-M-X--------M-oo--TM?---|B-M--X-o-----|----o--TE-X--B-|o|-?--T?|-o-|B---?
E-T-?Eo-TX---B--|B-----|----Xo-oB-E---oE-Bo--B-oTB--B-EEo??X-?-o-ME-TM-?-------B|---ME---oM-oo-B----|X----X|----E---T---?XX-?--BM---B?MM--|--B---oT--?X---B---XM--EE--TEX?--|-B--|-MXX|---BX||------B|-o
M---?T--oE-?---?--|E?-------TE-----ooo-o-----|--o-----o-||X-oXX------TX-----M-E-oo-?BE-TME?Bo-?--|-----|-M-TM---o---?--|-?E|M-|--|-|M--E-o--o-X---|-MTXE---M--MX-|---M--|M--X--?X--B--X--?------oB---EXX
oo-|--E?B-?|-EM-oETTME--MM-|--|B--Mo-T----?-X|--BMo-B--?X-T-|XT?B--M|-M---?M--B----XEM---|EB-----T-o-?-T--EE-o?-M-Boo--EXB--oE--oB|---T--o-EMB-oM-------|---T--M--T-|---T-----o-------ME--E-oX?TB|oTM--|
TM--X|?---?-E?o----T|ME--|-XE---TE?--B---?|MXE-M---T-EBoM----BX-Eo---BT-BX-----|-------|o-|---ooTEEM??B----oo--T--o----?M--?o--B-X?---oX-B-|--E?M-T|--?oE--o-B----|--T--||XoX|-M------Xo--X-X|M----|MB-o
B|E--M--E---|-?|-|-X--T---EXX--B---M-|X---B----EoM---|T---?-XM-----|-|?--TTo-ET------B---X--B-EoM-----EM----B?--E------?----M|-XMX---M-|-|-B--|-|X-?-EE-|X------o-MT-|BEE----??E--o-----XB-----|T--To---
o-?--B---T-M-B-|--|-|--E-----|o----|-T|-ME-TToB-EB---T----B|E----E----|X---T|---T-|-B-|MM--MB-----X----B--T-B-ME--?-X---B---XBX-T-?--BE|?X-B|-BT-?BMo-oE?oME|----X--E-T-X-----o-B--o-M-XE--T----M-TXo--T
|X---X-T|TM----X-|o-T-M-BB-?M-o-Mo-----BoooM-B-E-EM-E-|Mo|EEM-B|-----o?-?E---M|-M----?MX---E-Xo--X?-TT|--o-T----M-oM-o-X-EoX-XBo--EB--|-|-B---||---X--B--o-?oo---BB--o---X|o---EMM-TT-Mo-?--B--B---oM-?v
EoB--MT-T----B-?---ME--X---TT---X-MoE-M-E?X-oT-----T-?--T?M---T?----|----T--oET?-EB-B-E-----o-T-E----|--M--o?--M--B---XXT-o------B----M-oE?-B-E-B--?-?--T-T-----oM----E?MBo-?-T---Bo?-XT-X-------B-M-M-|
X--o-|-Eo-T----X-X-EB----M----?|MB-?|T-Eo-|-?-X-o----BM--X--T----M-----MoM-X-MT--M-M---BEo-X?-o-?B-EB--X----EX?-E--B-MB-E-MBM?--EXMo-TEE-----X-XMoE|-----Bo|-|----BM-X-Bo-|M?X-M---?-EMTT|--o---?-BM---B
M------X-?|E-BT----?-----B--T?-X-TM-XT---|-M?|--?--M----XEo----|?T--MTo------M-----E-|---B-MT-E------XT-o--ToTE---?---E|-|XMTT-?-------|-X------|oo---T-M----T--oT--B--?----MM--?--o----E-E-M?-?E----?--
BX-E?BB----E-BMT-BT------B-XE-?-BM--o?XMo-B--|B---M-M--|o-------T-XXMX-------BoBT-|---M-M?M-X-EE-B-----M-?----|---T-?-o-B-o--T--?|--MT|-X-----T|---X?----B----M-|----|-BoT?ooMEB--E-o--Bo--?-|XB---XTMo?
T-|MToM--?-E|BXM---|----XBo-B-?-MB-?Xo-M--MBM?---E|--o-EMT---||?---M-E---BM-|--BX-oM--?T--oo?T--M-M-------T|B-oM-?-Bo--|T-M-|B|M--oM-X-B-?M-?--EEXB-?T?---o-----------o---|-E--X-B-TME---EM--E-?-M-----B
ME--E---T--ETTMM|B|--?X--X-|-------XEEM----XoX---Mo|?-B----TM--E--?T-M--E-|M-o----TB?----E?|XB-|-B?---?--o-X--|--|---EE---M?---X-?-BMo-B---|o-B-T|-?TEMB---B-X-M--EM-TX-o-------X--E-|-|?-?B---?B-?B-?-B
m-|TXo-TT-E--MBM--X?--|T--MT-X-?B---XT---T-?EM--TE-MB?|---?X-?-T--B-B--o----M---X-M-o---TX?-XMB----TME-TBBM-B|B-|----E-----T----X--oMBo--XM--EoX-MB-T-X---|---E-E--|-E--T-T--?BB---B-|--o--BM-?-o---EB|M
XXXXXXXXXXXXXXXXXXXXXXXXXXXXXXXXXXXXXXXXXXXXXXXXXXXXXXXXXXXXXXXXXXXXXXXXXXXXXXXXXXXXXXXXXXXXXXXXXXXXXXXXXXXXXXXXXXXXXXXXXXXXXXXXXXXXXXXXXXXXXXXXXXXXXXXXXXXXXXXXXXXXXXXXXXXXXXXXXXXXXXXXXXXXXXXXXXXXXXXX
