----X--oX?E-------BBE----o-B-B-X?------B-E|--T-X-oX---E--o--BMTX-|--|?-|B--E--|T?X---X-E-o?o-oE-B-|E-oT?M--|?--|----?-X-oM|---?-|-EB-M--o?--TB-----E-BM--|-E-E-oE-T-----MoT-----XE------TX--T--B--------
----|-o---MoM-TM---XX---?-o---BTE--X-B-|-T?-T-------|BBo-----M-|-----|--E-?o-oT--------------X-X---?-------T-B-E-----XM|B----|o-oB-|----ME-E-TB---|-----|----|BM--X--------o-o--T--B--T---?MX------?----
-------------|XoB----X|E-T--X---Eo-MB-TT?-------TB---T-?o----X|--XE--|X|-E-------||-TX----o-E-----M-X-T?-|------E---o-------oT-?-E--?E?E|TT--M-BooEB---oT|-------|BTXoo----?o-X-o?M|-T-EMT??--------|o--
-----?E------E----B-BEoo--X-|----E--------T-o-T-?---|B----?-X|----o?-|----E-|o-o-M-X--|---E-----o--T----?|o-oE|---B---X?M----B--o-XXE--E|E--oE----|-EET-|--?M------?|----XMo-|T----?B--M?EoM-T--B-M--E--
-E--M?---|--|oE-?EB----?-B-?----T-|?-M-B------?-?-----EX-----B----XT-E|-------o---|E-E?--M-BET|-E?T--|---X-E|-|T-?-|-T-TB--oM---BTMX--E---|-B--T---TXo------Tooo|MM---M-?|--B?BME|X-EBEXMX-|--TB----T---
-B-o|BXMB|-----------EM-X?-?|-|--?--|-|-oB-----|E-----?-BoX--M-oB--M?--B---T|oo--E-ooE------M-EB-|||--MT---X|X----T-T--X-|--BB--M-o----o---TT---o--E---M--MBMM----o-MX-------XBX-MB--X--o-M----E-?-TBE--
-MX?MEXX|B---EE-?M-----o--?----|-------B|----Mo?T-?-TT-B----?----M-oM--EBXE-|---|E------BB-B----BT---E----o---X?o?--|?BE--o----o-T-M-----?XB-oT?-MoXTo--E|X-TX---XX--------X?T-TM-TMo-M------o--B--|----
---E?---X--M||--TM--oo---?E-B----------|----MEB|-o-------------TE|T----T|-XoB-o---o|T-T---|-T----------o-T-?-----T-?---X------E--M----------MB---M------B-Xo-XMM--BT--oB-?-|-X?-B-X--------E--??|--?-X-v
--?T--TMM---?---BT-M-Xoo-?|X-Mo--|M----T-E--TXB---E-||B--X----M-MX---B-EX-----BBEoXEo-??------T-XE?E---?M-----M-?oB|--MT-----TE?--B---TMEX---X-XB-T-XX--MM---??|-----TXET---T-Eo-X-----|Mo-TE----XB-MB-f
-?-?--o-M---E------T-B-B-TE-?---BE---B-E---T|-----X-?--?o----M-MXE-Mo--E----?X--?B-|-TMToXB--XB---?-M----?----?-E-M-T--M---TX--------|-X-MB-E-----|?|-E--?--?--BT-|-M--T----T-----o-X--E-T-EB-Mo--E-o-Mf
-BXT-??B?oEB--E-X-ET-------E--T----|MT----o-?-B-EB----?BTX-o-----B---X----B|o-MTBB-X-|||M---ooTE--oE--B-E-o--|-?--T---E|-B----X---M--o---o---M---?-M--M--|--X---|-T--?-X|--EEE-T-|Eo?-----o------?--X--f
-ET-|-o?--EE?-----TMBo-o-o--------T-X--||--E?E--?TBE-E|To|------M-|X---|ME---X-|E--BT-E-M-B?||X-|--E--B|--B--o|-T-MX-|-E--B------o?--Bo--oE-?----oEXoET-o?|T---?XM----X--TX-B---EE|?T-----TX-?--------Tf
-E--Eo-M-----ME-T-o----o??M-|-MX--|--|---|?T--E--T--------oEXETX-?-|oT-E-o--B----o---To?----?--ET--B?-X----MEE--------BX-E--||-B-M-TM-M-BB-?-X?---oT----?B-E|-MM--||-M-E-o--E--EE-M-?Eo-|--|-BX--|-T---f
--??-o-----------M---T----|-TBMBT-o--B-TM----M|M-T--MX-----XB-X------T-?---ET----|X---E|T--E-?---o-|----BB--M-E-T-|-X-ET-o-|--EB?oXX-T---B---|?XB----MB--E|-E|---X-|EXMM---M-oXo--B|-----B?o-M||TBT-X--f
m-|-B--E-E---E-B---E?--MEX|-M----?-ME?||--|B?---M-------TT----o------E-?--E|--ME--T--o--o|-M---T-oT----o----T|-?o|-M---|----T--?--To-|-X-TB-T--B--EX--M-ToE|M-|?-|X-o-o--|E-o-oT-??-T-X---|XE-X----?--EX
XXXXXXXXXXXXXXXXXXXXXXXXXXXXXXXXXXXXXXXXXXXXXXXXXXXXXXXXXXXXXXXXXXXXXXXXXXXXXXXXXXXXXXXXXXXXXXXXXXXXXXXXXXXXXXXXXXXXXXXXXXXXXXXXXXXXXXXXXXXXXXXXXXXXXXXXXXXXXXXXXXXXXXXXXXXXXXXXXXXXXXXXXXXXXXXXXXXXXXXX
