----XXXXXXXX-------------------------------------------------------------------------------------------------------------------------------------------------------------------------------X-M----------
--------------------------------------------------------------------------------------------------------------------------------------------------------------------------------------------------------
--------------------------------------------------------------------------------------------------------------------------------------------------------------X----------------M-M---B------------------
-----------------------------------------------------------------------------------------------------------------------------------------------------------------------------BBBBBBBB-------------------
-------------------------------------------------------------------------------------------------------------------------------------------------------------------------------o----B----------o--------
------------------------------------------------------------------------------------------------------------------------------------------------------------?---------------------B-----------BBBBB????-
---------------------------------------------------------------------------------------------------------------------------------------------------------X--------------------------o---------------BBB-
----------------------------------------------------------------------------------------------------------------------------------------------------B----XX---o-----------o----------X--o-----------X--v
--B------------------------------------------------------------------------------------------------------------------------------------------------------XXX----------------------------B-------XXXXXXXf
----------------------------------------------------------------------------------------------------------------------------------------------------?----XXXX--------------------M------B-BBBBB-----XXXf
---------------------------------------------------------------------------------------------------------------------------------------------------------XXXXX---------------X-----------?????------XXXf
---------------------------------------------------------------------------------------------------------------------------------------------------------XXXXXX--------------XX-----------o---------XXXf
------------------------------------------------------------------------------------------------------------------------------------------------T----T-T-XXXXXXX-------T-T---XXX--------To-------TT-TXXf
------------------------------------------------------------------------------------------------------------------------------------------------|----|-|-XXXXXXXX------|-|---XXXX-------|--------||-|XXf
m--------EE------------------------------------------------------------------------------------------------------------------------E------------|----|-|-XXXXXXXXX-----|-|---XXXXX-E-E-E|--o---E-||-|XXX
XXXXXX----XXXXXXXXXXXXXXXXXXXXXXXXXXXXXXXXXXXXXXXXXXXXXXXXXXXXXXXXXXXXXXXXXXXXXXXXXXXXXXXXXXXXXXXXXXXXXXXXXXXXXXXXXXXXXXXXXXXXXXXXXXXXXXXXXXXXXX|XXXX|X|XXXXXXXXXXXXXXX|-|---XXXXXXXXBBX|--------||X|XXX
