---------------------------------------------------------------------------------------------o------------------------BBBBB--------------------------------------------------X----------o------?-oo-----
-----------------------------------------------------------------------------------o---------------------------o------MX--M---------------------------------------------------XMXXXXX---------------?---
--------------------------------------------------------------------------------------------------------------M--------------------------------------------------------------------------o-------BBBXXX-
-----------------------------------------------------------------------------------------------------------M--------o-------------o-------------------------------o----------------------?XXXXXXX----o--
-------------------------------------------------------------------------------------------------------o----------------------o----------------------------------------------------------------o?----X--
--------------------------------------------------------------------------------------------------------------------------?---o-------o-------------------------------------------------X--------o-XXX--
-------------------------------------------------------------------------M---------------------------------X-------------------o----------------------------------------------------XXXXXXXX------XXXXX-
----------------------------------------------------------------------------------------------X----------o-X----------------------X-----------------------------------------XXXXXXX---XXX------X-XXXXXXv
---------------------------------------------------------------------------------------------XX--X-X--BMBBXX-------------X-----B-XX---------------------------------------------X----XXXX-B--XXXXXXXXXXf
---X--------------------------------------------------------------M-------------------------XXX-XX-XX----XXX-------------XX-B---XXX-------------------X-------------------o---------XXXXX-----XXXXXXXXXf
---XX----------------------------------------------------------------M---------------------XXXXXXX-XXX-BXXXX?------------XXX---XXXX------------------XX----------------------------XXXXXX-----XXXXXXXXXf
---XXX------------------------------------------------------------------------------------XXXXXXXX-XXXXXXXXX-------------XXXX-XXXXX-----------------XXX---------------------------XXXXXXX----XXXXXXXXXXf
---XXXX----------------------------------------------------------------TT--------TT----T-XXXXXXTXXTXXXXXTXXX?-------T----XXXXXXXXXX--T----TTT------XXXX----------------------T---XXXXXTXX---XXXXXXTXTXXf
---XXXXX---------------------------------------------------------------||--------||-XXX|XXXXXXX|XX|XXXXX|XXXX-------|---oXXXXXXXXXX--|----|||-----XXXXX----------------------|--XXXXXX|XX--XXXXXXX|X|XXf
m--XXXXXX---------------------------------------------------E-E--------||--------||----|XXXXXXX|XX|XXXXX|XXXXX------|----XXXXXXXXXX--|----|||-?-EXXXXXX--------------------E-|XXXXXXXX|XXBXXXXXXXX|X|XXX
XXXXXXXXXXXXXXXXXXXXXXXXXXXXXXXXXXXXXXXXXXXXXXXXXXXXXXXXXXXXXXXXXXXXXXX||XXXXXXXX||XXXX|XXXXXXX|XX|XXXXX|XXXXXX--o-X|X---XXXXXXXXXXXX|XXXo|||XXXXXXXXXXXXXXXXXXXXXXXXXXXXXXXX|XXXXXXXX|XXXXXXXXXXX|X|XXX
