---------------------------------------------------------------------------------------------------------o----------------------------------------------------------------------------------------------
--------------------------------------------------------------------------------------------?-----------------------------------------------------------------------------------------------------------
--------------------------------------------------------------------------------------------------------------------------------------------------------------------------------------------------------
--------------------------------------------------------------------------------------------------------------------------------------------------------------------------------------------------------
-------------------------------------------------------BBoBB--------------------------------------------------------------------------------------------------------------------------------------------
------------------------------------------X-----------------------------------------------------?-------------------------------------------------------------------------------------------------------
--------------------------------------o-----------------------------------M-----------------------------------------------------------------------------------------------------------------------------
---------------------------------------------------------------------------------------------------------------XXXXXXX---M-----------------------------------------------------------------------------v
--------------------------------------------------------BBBBB-------------------------------------------------------XX--------------------------------------o------------------------------------------f
---------------------------------------------------------------------XXXXX----------------------------------B------XXX---------X-----------------------------------------------------------------------f
-------------------------------------B----------------------------------------------------------------------X-----XXXX--------XX--------X--------------------------------X-----------------------------f
--------------------------------------------------M---------????--BBB---------------X----------------------XX----XXXXX-------XXX-----------------------------------------------------------------------f
---------------------------------------------------------T-T----------TT?-----X-----XX---X-T-------T------XXX---XXXXXX------XXXX---TT----------????????-------------------------------------T----------f
-----------------------------------B---------------------|-|----------||-----XX-----XXX-XX-|-------|-----XXXX--XXXXXXX-----XXXXXo--||-------------------------------------------------------|----------f
m---------------------------------------------------E----|-|-E--------||----XXX---E-XXXXXX-|-------|----XXXXX-XXXXXXXX----XXXXXX---||-----------E-------------------------------------------|----------X
XXXXXXXXXXXXXXXXXXXXXXXXXXXXXXXXXX--------XXXXXXXXXXXXXXX|X|XXXXXXXXXX||---XXXXXXXXXXXXXXXX|XXXXX-X|XXXXXXXXXXXXXXXXXXXXXXXXXXXXXXX||XXXXXXXXXXXXXXXXXXXXXXXXXXXXXXXXXXXXXXXXXXXXXXXXXXXXXXX|XXXXXXXXXXX
