-------------------------M------------------------------------BBBBBBBXXXXXBBBBBBB------------------------oo-------------o-----oo--------------------------------------------------------------o---------
----------------------------------o---------------------------------X-----------X---------------------BX---------------o--------------M--o??????---o-----------------------------------??????-----------
----------------------------------------------------------------------------X-----?----?------------X---o----X---------BBBBB-?------BBBBB-----------X-------------M----------------------------XXXXXX-o-
----------o---------------------------------------------------------o--------M-----------B-T------X---T-----------M----------------------------------------------------------------T-----M---T-------T--
--------------------------------o------------------------------oM---------T----------?-----|-o--------|----o------???---M-X-X---T---T---------------M-----------------------------T|------Xo-|---XXXX|--
----------------------------------------------T----------------------T--BB|B--------------T|-----XT---|-????????---X---T-XXXX---|---|---T----X-------------------?------X---------||X-o-----X|----XXX|X-
----------------------------------------------|-----X----------------|---X|---------X-X---||-----X|---|-----BXBBBMXX-T-|XXXXX-o-|---|-B-|---XX-------------X-------------B--------||X-------X|?------|X-
----------------------------------------------|-----XX-------------M-|--XX|--------XXXX-BB||B-X--X|X--|------XX--XXX-|-|XXXXX---|---|---|--XXX----T-------XX--------------------T-||X-------X|X-----X|Xv
----------X----------------------------o------|-----XXX--------------|-XXX|-----?-XXXXX---||T-XX-X|XX-|-----TXXXXXXXT|X|XXXXT--T|--X|---|-XXXX---B|BBBBB-XXX----------??????XXXX|X||XM------X|XX---XX|Xf
----------XX----------------------------------|-----XXXX-------------|XXXX|---X--XXXXXX---|||-XXXX|XXX|T-M--|XXXXXXX||X|XXXX|-X||--X|-o-|XXXXX----|-----XXXX-----------------TBB|X||X-------X|XXX-XXX|Xf
----------XXX----------------T-------X--------|-----XXXXX----XXXXX---|XXXX|---XXXXXXXXX-BB|||XXXXX|XXX||----|XXXXXXX||X|XXXX|X-||-MX|X--|XXXXX-X--|----XXXXX-----------T-----|?X|X||X------TX|XXXXXXX|Xf
----------XXXX---------------|--T----XX-------|-----XXXXXX----------X|XXXX|---XXXXXXXXX-XX|||XXXTX|XXX||X--X|XXTXXXX||X|XXXT|XX||--X|XXX|XXXXX----|---XXXXXX-----------|-----|XX|X||XT-----|X|XXXXXXX|Xf
----------XXXXX--------------|BB|BBB-XXX------|--X-?XXXXXXX---X----XX|XXXX|BB-XXXXXTXXX--X|||XXX|X|XXX||XXXX|XX|XXTT||X|XTX||XX||--X|XXX|XXXXX----|--XXXXXXX-----------|----?|XX|X||X|-----|X|XXXXXXX|Tf
----------XXXXXX-------------|-T|o---XXXX--M--|XXXX-XXXXXXXX-XX---XXX|XXXX|--XXXXXX|XXX-XX|||XXX|X|XXX||XXXX|XX|XX||||X|X|X||XX||--X|XXX|XXXXX-T--|-XXXXXXXX-----------|----X|XX|X||X|----o|X|XXXXXXX||f
m---------XXXXXXX--E----EE---|-||E---XXXXX-BE-|--XXXXXXXXXXXXXX--XXXX|XXXX|EXXXXXXX|XXXXXX|||XXX|X|XXX||XXXX|XX|XX||||X|X|X||XX||XEX|XXX|XXXXX-|--|XXXXXXXXX--EE----XXX|X--XX|XX|X||X|----E|X|XXXXXXX||X
XXXXXXXXXXXXXXXXXX--XBBXXXXXX|X||XXXXXXXXXXXXX|XXXXXXXXXXXXXXXX-XXXXX|XXXX|XXXXXXXX|XXXXXX|||XXX|X|XXX||XXXX|XX|XX||||X|X|X||XX||XXX|XXX|XXXXXX|XX|XXXXXXXXX------Xo---|--XXX|XX|X||X|---XX|X|XXXXXXX||X
