-----------------------X---o----XXX------X--X-------Bo---M--------B---B-----------------------BBBBBBB-o---XB------X--------------B-------------XX-------------------------------------------------????--
---?------o------------B---------------XoXXXM-???----BoBBBBB-XXXXXXXX-----------------M------------------M----?----------------------------------------------?------------------B------BBB--------------
---------o--------X---M-BBB--???????M---------B--BX---M-----------------------------------------------?--------------------------------------------------?----------------------------------------------
----------------------?--M---B---M-o-o------??????-B-------?BBBBBBBBB--o-----------o-----------?-----B---------o----o-----------------------------------------------------------------------------------
-----???M------X---B---X--------X-?o--?-------?----B--?----------X--------?----------o-B---M---------------X----M?------------------BBB--------------------------X----BBBBBBB---------------------------
--------X-----XX----------XBBBBXXBBBBB------o---XBB?-X--M---X--XXX---X-----------------XXXXXXX?------MXX-----------o--X-----M-----------------------------------XX--------------------------------------
---o?o??XX??-XXXX-------oXM---XXX---X-----X-o---XXXXXXXX----XXXXXXBBBXX-???----------------------?---XX----oB--X------XX--o--B---------------------o-----?-----XXXX-------------M-------BBBBB-----------
------o-XXX-XXXXX-------BXXXoXXXX---XX----XX---XXXX--XXX----XXXXXXX--XXX--X-----?-----X---??????----XXXX-------XX---M-XXX-------------------------------------XXXX----------------------BBB------------v
-M------XXXXXXXXX---X---oXXXXXXXXX--XXX-M-XXXBXXXXXXXXXXX--BXXXXXXX--XXXX-XXo----------------------XXXXXX------XXX----XXXX-----------------?-----------------XXXXX----------o-------------X------------f
--------XXXXXXXXX---XX??oXXXXXXXXX--XXXX--XXXXXXXXXXXXXXXX?XXXXXXXX?-XXXXXXXXBBBBo--o----?X-------XXXXXXXX-----XXXX?--XXXXX---------------------------------XXXXXX---------X-------??????-XX-----------f
---XBXXXXXXXXXXXX--XXXX-XXXXXXXXX?X-XXXXXXXXXXXXXXXXXXXXXXXXXXXXXXX-XXXXXXXXXX---X---X--M-----o--XXXXXXXXXX----XXXXX--XXXXXX-------------------------------XXXXXXX--------XX--------------XXX----------f
---XXXXXXXXXXXXXX--XXXXXXXXXXXXXX-o-XXXXXXXXXXXXXXXXXXXXXXXXXXXXXXX-XXXXXXXXXXXMXX-------------BXXXXXXXXXXXX---XXXXXXXXXXXXXX-----------X--X--------?-----XXXXXXXX-------XXX--------------XXXX-------??f
-T-T-T-TXXXXXXXXX-TXXXTXTTTTXTXTT-T-TTXTXTXXTXXTXXXTTTXXTTTXXXTTXXXXXTXXXTTXXTXXTX--T-T----T-T-TXXXXTXXXXXXXT--XXXXXXTXXXXTXXX-T----T-----XXT---T-----TX-TXXXXXXXX-o----XTXTT----T-T------TXXXX--T---XXf
-|-|-|X|XXXXXXXXXX|XXX|X||||X|X||X|-||X|X|XX|XX|XXX|||XX|||XXX||XXXXX|XXX||XX|XX|X--|-|----|-|X|XXXX|XXXXXXX|X-XXXXXX|XXXX|XXXX|X---|---XXXX|---|-----|XX|XXXXXXXX-----XX|X||----|-|-o----|XXXXX-|-----f
m|E|X|X|XXXXXXXXXX|XXX|X||||X|X||X|-||X|X|XX|XX|XXX|||XX|||XXX||XXXXX|XXX||XX|XX|XX-|E|-E--|-|X|XXXX|XXXXXXX|XXXXXXXX|XXXX|XXXX|XX--|E--XXXX|--E|----X|XX|XXXXXXXX-E--XXX|X||EE--|-|------|XXXXXX|-----X
X|-|X|X|XXXXXXXXXX|XXX|X||||X|X||X|X||X|X|XX|XX|XXX|||XX|||XXX||XXXXX|XXX||XX|XX|XX-|X|----|X|X|XXXX|XXXXXXX|XXXXXXXX|XXXX|XXXX|XXX-|--XXXXX|XXX|XXXXX|XX|XXXXXXXX---XXXX|X||X---|-|--XXXX|XXXXXX|-XXXXX
