------------------------------------------------------------------------------------------------------M--------------------------------o-BB-------------------------------------------------------------
---------------------------------------------------------------------------------------------------------------------------------------------M----------------------------------------------------------
--------------------------------------------------------------------------------------------------------------------?-------------------o----?????---------------------------------X--------?-----------
--------------------------------------------------------------------------------------------------------------------Bo-------?----X------XXXX----------o------------------------------------B-----------
-----------------------------------------------------------------------------------------------------------------------X------------o----------------------------------------------------------------B--
-------o--------------------------------------------------------------------------------------------------------------XX----------------?---X-------X----------------------------------------------M----
---------------------------------------------------------------------------------------------------------X-----------XXX----------------X--XX------XX---------------------o---?---------------X-------X-
-------------------------------------------------------------------------------------------------------------X------XXXX------------o--XX-XXX?----XXXX---------------------------------------XX-------Xv
------------------------------------------------------------------------------------------------------------XX--B--XXXXX--X----------oXXXXXXXB---XXXXX--------------------------------------XXX-------Xf
------------------------------------------------X----------------------------------------------------------XXX----XXXXXX-XX----X?---XXXXXXXXX---XXXXXX-------------------------------------XXXX-------Xf
-----------------------------------------------XX-----------------------X---------------------------------XXXX---XXXXXXXXXXBB-XX-o--XXXXXXXXXBXXXXXXXX------------------------------------XXXXX-------Xf
----------------------------------------------XXX--------------------------------------------------------XXXXX--XXXXXXXXXXXo-XXX---XXXXXXXXXXMXXXXXXXXXX-------X-------------------------XXXXXX-------Xf
---------------------------------------------XXXX---------------------------------T---T-------T-----T---XXTXXXTXXTXXXXTXXXX-TXXT--XTXXXTXXXXXTTXXXXXTX--------XX--B--------------T-T----XTXXXXX--T-TTTXf
--------------------------------------------XXXXX---------------------------------|---|-------|-----|--XXX|XXX|XX|XXXX|XXXXX|XX|-XX|XXX|XXXXX||XXXXX|X?------XXX-----------------|-|---XX|XXXXX--|-|||Xf
m------------------------------------------XXXXXX-------------------------------E-|---|-E-----|-----|-XXXX|XXX|XX|XXXX|XXXXX|XX|XXX|XXX|XXXXX||XXXXX|X------XXXX------------E-X--|-|--XXX|XXXXX--|-|||XX
XXXX----------XXXXXXXXXXXXXXXXXXXXXXXXXXXXXXXXXXXXXXXXXXXXXXXXXXXXXXXXXXXXXXXXXXXX|XXX|XXXXXXX|---XX|XXXXX|XXX|XX|XXXX|XXXXX|XX|XXX|XXX|XXXXX||XXXXX|X-XXXXXXXXX-XXXXXXXXXXXXXXXX|X|-XXXX|XXXXXXX|X|||XX
