--------------------------------------------------------------------------XXXXXXX--X----M--????????-----B---------o-------M------------------------B-------------??----------X------------------o-------
--------------------------------------------------------------------o-------------------------?---------o----------?-B-------------------BBBB---o-----------X-oo----X---XX?-o?------XXXXXXX-------X-----
--------------------------------------------------------o-----------o-----M--------------?-----------------------------------M---------------BBBBBBB--------------????XXXXXX----------X-?-------------B-
-----------------------------------------------------------------------o----------------------o-------o-------T------------------------------------------T-?-BTBBBB?B--------T-XXXXXX---BBBBBBBB--------
-------------T---------------------------------T---------------------------T------------------------T------X--|---------X------------------------T-T-----|-T--|----XXXXXXXX--|--?XXXBoXo--XTXXX---X-M---
-----o-------|---------------------------------|---------------------------|-------------------TXBT-|-----XX--|-----???XX???--------------o------|X|----?|?|T?|----------XX-X|--T-------BXX|XX-X-XXB-XT-
-------------|---------------------------------|---------------------------|-------------------|XX|o|----XXX--|-------XXX-M---T-----------o------|-|---T-|?||?|??-------XXXXT|--|X-X----XXX|XXXXXXXoXX|-
-X-----------|---------------------------------|---------------------X-----|-o--------------BTB|XX|B|---XXXX--|------XTXX----o|------------------|-|--o|-|B||B|B----???XXXXX||--|X-XT?-XXXX|XXXXXXXXXX|v
---X---------|---------------------------------|------?---X---------XX-----|------T--B------X|-|XX|X|--XXXXX--|-T---XX|XX-----|------------------|-|---|X|-||-|T---X-?XXXXXX||--|XXX|XXXXXX|XXXXTXXXXX|f
---XX--------|---------------------------------|----------XX-------XXX-----|?T????|--To----XX|-|TX|X|BXXXXXX--|-|XXXXX|XX----X|------------------|-|---|X|-||-||XTXX?XXXXXXX||--|XXX|XXXTXX|XXXX|XXXXT|f
---XXX-------|---------------------------------|----------XXX-----XXXX-----|-|--?-|--|-?T-XXX|-||X|X|TXXXXXX--|-|-XXXX|XXT----|-------------M----|-|---|X|X||T||X|XXXXXXXXXX||X-|XXX|XXX|XX|XXXX|XXXX||f
---XXXX------|---------------------------------|----------XXXX---XXXXX-----|-|--o-|--|-T|XXXX|-||X|X||XXXXTX--|-|XXXXX|XX|-T--|-------------XBBBB|X|---|X|X|||||X|XXXXXXXXXX||-M|XXX|XXX|XX|XXXX|XXXX||f
---XXXXX-----|---------------------------------|---------MXXXXX-XXXXXX----X|-|----|X-|-||XXXX|-||X|X||XXXX|XX-|-|XXXXX|XX|X|--|------------XX----|X|---|X|X|||||X|XXXXXXXXXX||--|XXX|XXX|XX|XXXX|XXXX||f
---XXXXXX----|---------------------------------|----------XXXXXXXXXXXX----X|-|----|XX|-||XXXX|-||X|X||XXXX|XXX|X|XXXXX|XX|X|--|-----------XXX-T--|X|X-X|X|X|||||X|XXXXXTXTXX||X-|XXX|XXX|XX|XXXX|XXXX||f
mE-XXXXXXX---|---------------------------------|----------XXXXXXXXXXXX----X|X|E--E|XX|X||XXXX|E||X|X||XXXX|XXX|X|XXXXX|XX|X|Eo|----------XXXXE|-E|X|XXX|X|X|||||X|XXXXX|X|XX||XX|XXX|XXX|XX|XXXX|XXXX||X
XXXXXXXXXXXXX|XXXXXXXXXXXXXXXXXXXXXXXXXXXXXXXXX|XXXXXXXXXXXXXXXXXXXXXXXXXXX|X|----|XX|X||XXXX|-||X|X||XXXX|XXX|X|XXXXX|XX|X|XX|X----XXXXXXXXXM|XX|X|XXX|X|X|||||X|XXXXX|X|XX||XX|XXX|XXX|XX|XXXX|XXXX||X
