-------------------------------------------------------------------------------------XXXX----------------------------------------?-MBBBBBB?BB-XXXXXX-------------------------??---------------------o---
---------------------------------------------------------------------------------------------------------------B-------M-------B------B--------????????-------B----------------oBBBB-----------o--------
-----------------------------------------------------------------------------------o--o----------------------?o?-----------?--------M------------------------------BXXXXXXXXXXXXXXXXX---------?----M----
--------M--------------------------------------------------------------------------------------------T---M----XX-T---------X-----M-BBBBBB--------------------------X-----------------------X-T----XXXXX-
-----------------------------------------------------------------------------------------------------|M---T-BBX--|---------------X-?-TX-X---T----X------------------???T????---XTT--BBB?B??-X|XXXXBB-X--
-----T---------------------------------------------------------------X-----------o-------------T-----|----|--XXB-|-BB-----XXXXXXXXT--|T--X--|-X-XX-------------------X-|---?-?XX||---------XX|T---X-XXX-
-----|---------------------------------------------------o-----------XX----X-------------------|--X--|-To-|?XXX--|-----XX-XXXX-XXX|XX||XXX--|TXXXX-------------X-----XX|-----XXX||---X--X-XTX||--XXXXXX-
-----|X-------X------------------------------------------X-----X-----XXX---XX------XB------X---|B---o|-|--|XXXXT-|---oXXX-XXXXXXXX|-X||XXX--||TXXX-------------XX-X--XX|T---XXXX||---XXXXXX|X||X-XXTXXXv
-----|--------XX-----------------------------------------------XX----XXXX--XXX----TXX-----XX--X|X----|B|--|XXXX|B|o-TXXXXoXXXXXXTX|XX||XXXX-|||XXX-------------XXX--XXX||--XXXXX||X--XXXXXX|X||XXXX|XXXf
-----|--------XXX----------------------------------------------XXX---XXXXX-XXXX---|XXX---XXX-XX|XXT--|-|-X|XXXX|-|--|XXXX-XXXXXX|X|XX||XXXXX|||XXXX-----------XXXXXXXXX||XXXXXXX||XX-XXXXXX|X||XXXX|XXXf
-----|--------XXXX------o--------------------------------------XXXX--XXXXXXXXXXX--|XXXX-XXXXXXX|XX|T-|-|XX|XXXX|X|-X|XXTXTXTXXXX|X|XX||XXXXX|||XXXXXX----------XXXTXXXX||XXXXXXX||XTXXXXXXX|X||XXXX|XXXf
-----|--------XXXXX--------------------------------------------XXXXX-XXXXXXXXXXXX-|XXXXXXXXXXXX|XX||-|T|XX|XXXX|X|XX|XX|X|X|XTXX|X|XX||XXXXX|||XXXXXX----------XXX|XXXX||XXXXXXX||X|XXXXXXX|X||XXXX|XXXf
-----|--------XXXXXX-------------------------------------------XXXXXXXXXXXXXXXXXXX|TXXXXXXXXXXX|XX||X|||XX|XXXX|X|XX|XX|X|X|T|XX|X|XX||XXXXX|||XXXXXXX---------XXX|XXXX||XXXXXTX||X|XXXXXTX|X||XXXX|XXXf
-----|--------XXXXXXX------------------------------------------XXXXXXXXXXTXXXXXXXX||XXXXXXXXXXX|XX||X|||XX|XXXX|X|XX|XX|X|X|||XX|X|XX||XXTXX|||XXXXXXXX--------XXX|XXXX||XXXXX|X||X|XXXXX|X|T||XXXX|XXXf
m----|--------XXXXXXXX-----------------------------------------XXXXXXXXXX|XXXXXXXX||XXXXXXXXXXX|XX||X|||XX|XXXX|X|XX|XX|X|X|||XX|X|XX||XX|XX|||XXXXXXXXX---EE-XXXX|XXXX||XXXXX|X||X|XXXXX|X||||XXXX|XXXX
XXXXX|XXXXXXXXXXXXXXXXXXXXXXXXXXXXXXXXXXXXXXXXXXXXXX-XXXXXX---XXXXXXXXXXX|XXXXXXXX||XXXXXXXXXXX|XX||X|||XX|XXXX|X|XX|XX|X|X|||XX|X|XX||XX|XX|||XXXXXXXXXXXXXXXXXXX|XXXX||XXXXX|X||X|XXXXX|X||||XXXX|XXXX
