------------------------------------------------------------X-------------------------------------------------------------------------------------------------------------------------------------------
---------------------------------------------------------------------------------M------------------------------------------------------------------------------o---------------------------------------
-----------------------------------------------------o-----------------------------o-----------------------------------------------------------------------------------------------X--------?-----------
--------------------------------------------------------------------------------------------------------------------------------------------------------------------------------------------B-----------
-----------------------------------------------------------------------------------------------------------------------X-------------------------------------------------------------------XXXXX-----B--
-------o--------------------------------------------------------------------------------------------------------------XX--------------------------------------------------------------------B------M----
---------------------------------------------------------------------------------------------------------X-----------XXX------------------------------------------------M-o-X-----------------X-------X-
--------------------------------------------------------------------------------------------------------------------XXXX---------------------------------------------------XX-XXXXXXXX-------XX-------Xv
------------------------------------------------------------------------------------------------------------XB-----XXXXX--X----------------------------------------------oXXX---------------XXX-------Xf
------------------------------------------------X-----------------------------------------------------------------XXXXXX-XX----------------------------------------------XXXX---------XXXXXXXXX-------Xf
-----------------------------------------------XX-----------------------X-----------------------------------M----XXXXXXXXXX---------------------------------------------XXXXX-------------XXXXX-------Xf
----------------------------------------------XXX---------------------------------------------------------------XXXXXXXXXXX----------------------------------X---------XXXXXX------------XXXXXX-------Xf
---------------------------------------------XXXX---------------------------------T---T-------T--TT-------T---TXXTXXXXXXXXX-------------------------------------T-----XXXXXXX--T-T-T----XTXXXXX--T-TTTXf
--------------------------------------------XXXXX---------------------------------|---|-----?-|--||-----X-|---|XX|XXXXXXXXX-------------------------------------|----XXXXXXXX--|-|-|---XX|XXXXX--|-|||Xf
m------------------------------------------XXXXXX------------------X------------E-|---|-------|--||---EXX-|--X|XX|XXXXXXXXX-------------------------------------|---XXXXXXXXXEX|-|-|--XXX|XXXXX--|-|||XX
XXXX----------XXXXXXXXXXXXXXXXXXXXXXXXXXXXXXXXXXXXXXXXXX-----XXXXXXXXXXXXXXXXXXXXX|XXX|XXXXXXX|XX||XXXXXXX|XXX|XX|XXXXXXXXXXXXXXXXXXXXXXXXXXXXXXXXXXXXXXXXXXXXXX|XXXXXXXXXXXXXX|X|X|-XXXX|XXXXX-X|X|||XX
