---------------------------------------------------------------------------------------------o------------------------BBBBB--------------------------------------------------X----------o------?-oo-----
-----------------------------------------------------------------------------------o---------------------------o------MX--M---------------------------------------------------XMXXXXX---------------?---
--------------------------------------------------------------------------------------------------------------M------------------------------------------------------------BBBBB---------o-------BBBXXX-
-----------------------------------------------------------------------------------------------------------M--------o---------------------------------------------------------------------XXBXXXX----o--
-------------------------------------------------------------------------------------------------------o----------------------o-----------------------------------------------o----------------o?----X--
--------------------------------------------------------------------------------------------------------------------------?---o-------o----------------------------------X--------------X------X-o-XXX--
-------------------------------------------------------------------------M---------------------------------X-------------------------------------------------------------XX---------XXXXXXXX--XX--XXXXX-
----------------------------------------------------------------------------------------------X----------o-X----------------------X-------------------------------------XXXXXXXXXXX---XXX----XXX-XXXXXXv
---------------------------------------------------------------------------------------------XX--X----BMBBXX-------------X-------XX------------------------------------XXXXXX---X----XXXX-B-XXXXXXXXXXXf
---X--------------------------------------------------------------M-------------------------XXX-XX-------XXX-------------XX-----XXX-----------------------------------XXXXXXXX------XXXXX--XXXXXXXXXXXXf
---XX----------------------------------------------------------------M---------------------XXXXXXX-----BXXXX?------------XXX---XXXX----------------------------------XXXXXXXXXX----XXXXXX-XXXXXXXXXXXXXf
---XXX------------------------------------------------------------------------------------XXXXXXXX-----XXXXX-------------XXXX-XXXXX---------------------------------XXXXXXXXXXXX--XXXXXXXXXXXXXXXXXXXXXf
---XXXX----------------------------------------------------------------TT--------TT----T-XXXXXXTXXT---XXTXXX?-------T----XXXXXXXXXX--------------------------------XXXXTTXXXXTXXTTTXXXTXXXXXXXXXXXTXTXXf
---XXXXX---------------------------------------------------------------||--------||-XXX|XXXXXXX|XX|--XXX|XXXX-------|---oXXXXXXXXXX-------------------------------XXXXX||XXXX|XX|||XXX|XXXXXXXXXXX|X|XXf
m--XXXXXX---------------------------------------------------E-E--------||--------||----|XXXXXXX|XX|XXXXX|XXXXX------|----XXXXXXXXXX--X---------------------------XXXXXX||XXXX|XX|||XXX|XXXXXXXXXXX|X|XXX
XXXXXXXXXXXXXXXXXXXXXXXXXXXXXXXXXXXXXXXXXXXXXXXXXXXXXXXXXXXXXXXXXXXXXXX||XXXXXXXX||XXXX|XXXXXXX|XX|XXXXX|XXXXXX--o-X|X---XXXXXXXXXXXXXXXXXXXXXXXXXXXXXXXXXXXXXXXXXXXXXX||XXXX|XX|||XXX|XXXXXXXXXXX|X|XXX
