---------------------------------------------------------------------?--------------------------?????------------?XX---?--------------?------------XX-oXXXXXX-------------------------------------------
--------------------------------------------------------------------------------------------------------M------------------------------------o-------------------------------------------?-----o--------
------------------------------------------------------------------------------------------------------------------o-----------------------o---------BBB----------??????---------------------------------
----------------------------------------------------------------------------------------------------------------------------------------------------------------------------------------------------B---
-------------------------------------------------------------------------------------------------------------X?---M-----------o-------------------------------X-------BBB--------X-------?--------------
---------------------------------------------------------o------------------------------------------o-X--B--XX----XB-X--B----Xo---X----X---XXXX?XXXX--X------XX-----X-XX--------XX---------X--X---------
-----------------------------------------------------------------------------------------------MX-----XX---XXXX??XX--X------XX---XX?--XX---XX-----BXXXX-----XXX----XXXXX-X-----XXX---------XX????o---oX-
-----------------------------------------------------------------------------------------------------BXXX-XXXXXXXXX--XX--M-XXXX-XXXXBXXXX--XXX--X-BXXXXBBBBXXXX-XXXXXXXXXX----XXXX-----o---XXX------BBXv
------------------------------------------------------------------------------------------------------XXXXXXXXXXXXXXBXXXBBXXXXXXXXXXXXXXXX-XXXXXX?XXXXXoXXXXXXX--XXXXXXXXX---XXXXX--------XXXXX-----XXXf
-------------------------------------------------------------------X----------------------------X-----XXXXXXXXXXXXXXXXXXXXXXXXXXXXXXXXXXXXXXXXXXXXXXXXXX-XXXXXX-XXXXXXXXXX--XXXXXX------X--XXXXX------Xf
------------------------------------------------------------------------X---------------X----B-----X--XXXXXXXXXXXXXXXXXXXXXXXXXXXXXXXXXXXXXXXXXXXXXXXXXXXXXXXXXXXXXXXXXXXX-XXXXXXX------XXXXXXXXX-----Xf
--------X-----------------------------------------------------------------------XXXXXX--XX-------o-o--XXXXXXXXXXXXXXXXXXXXXXXXXXXXXXXXXXXXXXXXXXXXXXXXXXXXXXXXXXXXXXXXXXXXXXXXXXXX------XXXXXXXXXX----Xf
------------------------------------------------------------------T------T------T----T--XXX--T------BXXXXXTXXXXTXXTTXTXXXTXXXTTXXXXXXTXXXXXXXXTXXXTTTXXXXXXXXXXXTTXXXXXXXXXXXXXXXX--T---XTXXXXXXTTX-TXXf
------------------------------------------------------------------|------|------|----|--XXXX-|------XXXXXX|XXXX|XX||X|XXX|XXX||XXXXXX|XXXXXXXX|XXX|||XXXXXXXXXXX||XXXXXXXXXXXXXXXX--|--oX|XXXXXX||XX|XXf
m----o-E--------------------------------------X-------E-----------|--E---|??----|----|--XXXXX|-E---XXXXXXX|XXXX|XX||X|XXX|XXX||XXXXXX|XXXXXXXX|XXX|||XXXXXXXXXXX||XXXXXXXXXXXXXXXX--|-E-X|XXXXXX||XX|XXX
XXX--------XXXXXXXXXXXXXXXXXXXXXXXXXXXXXXXXXXXXXXXXXXXXXXX-X---XXX|-----X|XXXXXX|XXX-|--XXXXX|----XXXXXXXX|XXXX|XX||X|XXX|XXX||XXXXXX|XXXXXXXX|XXX|||XXXXXXXXXXX||XXXXXXXXXXXXXXXXXX|XXXX|XXXXXX||XX|XXX
