|------XT--BM----X-|---X--X-oE-||-|-T--B--oT-X--M|-o-X----T---|--M---?-||-----|--o?X-?---oX?-?-|--XX|--------X|-|---TX-----E-M--E--Eo-?EX---T-|--?EXX-?ToMBX--Bo?--B---?----E---B-o|----?-M-o|?--------E
Moo|-B|M--T------|B|-XBEToBoMToE-M-EM----o--B--------X?---|T---B--Too----BT--?--T-E-------XTM|TM--?---E---?E--E-----M--|----TXMT--|--|--M-o-?-TEX?--E--ME-------?|----T----EBo-E-|--o--o-B-X--X|-----|?o
-----|-|?-M--X----oo-B-T---X-|--?----|o--M---TTXT---M--Bo--o--B-------To-T|o----M-T-o|-||-X-M|-T----B-o-oMo---?--B------??------|BE------MBX-X----?-----?TB--E--TE---EB|------E?---BE------|-----T-EB--X
TX-T-B--|ooXM-ooToX-EM-X---E--|-T-o|-X--X-M-----E--E|--o------|--?B--X-o---?E-------E--X--oT--XoE--?----?----o--E-B------BMXXM-E-E?-----|------X--|-------o|X--X-E--|-----MB-B---B--ToT?XB--MMT---T-|--M
o--TB-M-||X-|T--MM---oM--|--T?-E-oM----?--T-B??----oXT-TEM-X----X--X-------o-M?------?X-TX---M-Mo----T-B-E-MT-|?--X|M--o-o?----||-X----------o-BBM----oX-E---T---?MoB---oXTME-MTT-|--E??-o-M-|E-X--M-ME|
-----E---?|--------BETT---B---oB-E-o-X---?--EBME-B-X|-EE-T--?---|-|-o-MX---X?----ME--TM-o-X?-ME---M-|--E---E-M--MBM--o?----T|E-o--?--o---M|B-BX?----ET-M-----E|?---X?B-o??-o---BEM-o|X--X---X------X?---
BEX-|--B--B---?--||E-E--M--T-E-|-----MT?E--?----?-o--X---T-----X?---o----To|-EoTX||XEX|-X|oT-X-XE------|---B---M-M-T-|MoX--?----E---|M-XBT-o-----X-M-EE-oB-o-To-?E---?----E?-T-----?-XX-X?-B--Bo---o---?
X--M-----o---?-----|-?--?-T--T?o?T--M--?-T|B-TT---B--EE--XME-----|T?---MXXX--T----B?--E-E?---------|X--oB-----Mo|----T?--XoE--E---B------TTE--|--TM-T-T-oT---E-----o----T-------------ET---?o---BoM--?ov
E-?-E?M--E-TB---E--M-?|MM-?|?-----|-Xo-E?--o-E--T---MB-E|----oE?--To--BXX--XBX---BBMT-?Eo-X|----o-?----B--X--E--|BE-B--X---E-----B?-T--X--oM-----B-oo-o-|X-E---?----M----------T---|--BT??M--|----M?----
TX-??--||-T-----?M--BMETX--|--Bo?-o-?--Bo--X|B-|-o----|o-------?o-oBXM?-?--?o-Bo--BB--XEX-o|M-o-E----?ToB-To---o---o--?-o-|-T----M|-o-----|-?-?TX-EE------M--B--T?X-oM---M-T--B---o-Eo?--E|------o--?-BB
B-Bo-E?M-X-----------XT--T-B-XoE---MX---------T---T-?o---X-?-EBT---B-?|-TE-XE|E--?MoT--TX--?-XE-X-X-oo--oX-o|---B------?---oXT--X-?o---?-M-X-M--oE|-EEB-|-T---?-?-o-B-|B----MBo-X---|TEo-B-|-o-?-E-X--TB
EoE--?-?B-T-o|--|?-B--|---MT--M---E-??--XTX-B-BB--o-E-?|E---X--M--E-oX---?B|---T-E--?-||-E-?-B----X-o|-o-oX---oo|--B--?|-XX--E-E-?-?--|---o-E--?-T--?-TBBoo?TB-B---?----o-----|--oT--T-Mo|||--BM?B--T-|o
M--B-XMM|-TEM----|M-?----M??-----TT---?B--M?E--|-T?----TXM--o-----T----T------B-T----oE?-?---T---oMo?|T---?-M----o-BTX---MT-M--o------o-?MT--?---M-----BX--|-------T?-----T-BB-MT--B?-o--Bo-MM--T-o-T-B|
XM--|-T--M---M--?-|-T-o----M-E----X---XoB-M-ME-oBM-EM?---|?XoBE--|MB-oM?Xo|M--XB-BX--E---?X-?B-o----------X-oMXBM-T?-X-Eo-T--E-||---oTBT------MTooMo-oE--B--MXEE-X-EB-?X-|--|TB----T---M----X-?-TX--oM-|
m---B??E-oXB-BXBT----E----X-TX---|-?-TBoXB--M-TBB----TT-E----B-o|-XE---oM?EX-|T-?-|TT----|B-To--E-B-E|T-o--B-EX---TBToo-XoXM-B-E-T-T--?|Bo--EBXE---T-----?--E|--XT-Eo-|-T?--|-B---?--?-MMT--T|B--T-----|
XXXXXXXXXXXXXXXXXXXXXXXXXXXXXXXXXXXXXXXXXXXXXXXXXXXXXXXXXXXXXXXXXXXXXXXXXXXXXXXXXXXXXXXXXXXXXXXXXXXXXXXXXXXXXXXXXXXXXXXXXXXXXXXXXXXXXXXXXXXXXXXXXXXXXXXXXXXXXXXXXXXXXXXXXXXXXXXXXXXXXXXXXXXXXXXXXXXXXXXX
