------------------------E------------------X---------------------------------------------------------T------------------------------------X---------------E---------------------------------------------
-----------------------------------------------------------------|-------------------------------T-----------|-----------------|--------------------------------------X------------------------------|--
-|-----------------T--------X-----------------------T-----------------------------------------------------------------o--E------------------------------------------------------------------------------
----------X------E|---------o------E---------------X----------------------------------------------------|-------------------------------------------o---------------------E-------------------------|---
---|---|------X---------------------------X------------E---------|-----------------E-----------------------------------X------|-----------T------X----------------------------|-------X-----------------
--------------------E---------------------------o----------------T------------o----------X--------o------------------------------------------T--------T|-----------------------------------T------------
-----------------------------------------------------------------------|--T----------------E--------------------o--------T------------------------o-----E---------------|-----------X--------oT---------
---------------E-----------------------------E------------------------------------T-----X-------------------X-------------------------------------T------------------------E---------------------------v
-T------------E-----------------T---------X--------------------------o---------------------------------------------------------------------------------------------------------------------|-----------f
-o---------------------------X---------------------------------------------------------|------X------E-----------------------------X----------E--------------------o---TX----------------------o-------f
------------------T-o--E-----------------------------------------------------------------X-------------------------------------------E-----------E-|---------|-----------------------------------------f
-----X--------------------------T--------|---------------------------------T----------o-------|-------------------E--------o|---o-E-----------------------------------------------------|E--E----------f
----------E-------|---------------o-----------------|--------------------------------X--T-----------------------o---------------------------------------o------------|---------------------------------f
------------X---------------E---------------------------------------X---------X----T-|---------------|-----E--------T--------T-------|--------|--------------------------------------------------------f
m---------E-T---o-----|-----------------------------------------------------------------------------------T-------------------------E-----------------------------------X---X---o-E--------------------X
XXXXXXXXXXXXXXXXXXXXXXXXXXXXXXXXXXXXXXXXXXX-XXXXXXXXXXXXXXXXXXXXXXXXXXXXXXXXXXX|TXXXXXXXXXXXXXXXXXXXXXXXXXXXXXXXXXXXXX|XXXXXXXXXXXXXXXXXXXXXXXXXXXXXXXXXXXXXXXTXXXXXXXXXXXXXXXXXXXXXXXXXXXXXX|XXXXXXXXXX
