----|-----------------------------------------------X-------------------------------------------------------------------------------------------------------------------------------------------T-------
------------------E------------------X-------------------E---------------------------------------------------------------------------------------T-X------------------------------------o---------------
------------------------------T-----------------------------------------------T------------------------------------------X-------T------------------------------------------------------o-----X-E----E--
----------o---------------------------------o-------------------------------o--------------E----------------------o-------------E------E--------E-T----------------------------------X------------------
---------------------------Xo------|-------------------X--X--------------------------------------o--X-------------------------------T--------T---------------o---------------E--------------------------
----------------o------|----------------------------------------E--E----------------------------T---------------------------------------------------------------------------------|----------------X----
--|------------------------o-o-----------------------------------------------T-------------------------|-------o----X----------------------------------------------------------E-E-------------------E--
-----------|----------------------E------------------------------------------|-------------o|-----------------o-----X----------------------------------------------------------------------------------v
---------------oT------|-----o--------------------E--------------------------------------------T--------------T----------------|-------------o---------------------------------------------------------f
---------------E---------T----o-------------------------------T---|-----------------------X------------------|---------------------------------------T-------------------------------------------------f
-----|-----------------------|---------------------E----------------------T------------------|-----------------------------------o---------X------T------T--------X----------------T---T---------------f
-------------------------T-----o-------------|-----------------------------------E-----------------------T--X----------------------------------------------------------------------o-T-----------------f
---------------------------------------E-------------------------------o--------X------------------X--------------------------------------------X------------------------------------------------------f
-----------------------------------------------E------X-------------------------------E----------T------o----------------X-------------------|---------------------------------------------------------f
m------------------------------------------------------------------------------------------------------------------------------------------------------------------------------------------------------X
XXXXXXXXXXXXXXXXXXXXXXXXXXXXXXXXXXXXXXXXXXXXXXXXXXXXXXXXXXXXXXXXXXXXXXXXXXXXXXXXXXXXXXXXXXXXXXXXXXXXXXXXXXXXXXXXXXXXXXXXXXXXXXXXXXXXXXXXXXXXXXXXXXXXXXXXXXXXXXXXXXXXXXXXXXXXXXXXXXXXXXXXXXXXXXXXXXXXXXXX
