---------------------------------------------------------------------------------------------------------------------------------------o-??????---------------------------------------------------------
---------------------------------------------------------------------------------------------------------------------------------------------M------------------o-------------------------------BBBBBBB-
---------------------------------------------------------------------------------------------------------------------------------------------?????-----------------------o------BBBBBBBBBBBB------------
-----------------------------------------------------------------------------------------------------------------------------?-----------XXXX----------o--------------------------???-------B-----------
------------------------------------------------------------------------------------------------------------------------------------o-------------------X-----------X------------X---????--XXXXX-----B--
----------------------------------------------------------------------------------------------------------------------------------------------------X--XX----------XX------M----XX----------B------M----
----------------------------------------------------------------------------------------------------------------------M-----------------X-------X--XX-XXX------o--XXX---MBoBXB?XXXBB---XXXX----------XX-
------------------------------------------------------------------------------------------------------------------------------------o--XX-?--?-XX-XXXXXXX??XXX--BXXXX---X--XX-XXXXXXXX------------X-XXXv
--------------------------------------------------------------------------------------------------------------------------X-----------XXXBBoBBXXXXXXXXXXX-------XXXXX--XXoXXXXXXXX------------X--XXXXXXf
-------------------------------------------------------------------------------------------------------------------------XX---------XXXXXXX--XXXXXXXXXXXX-X-X--XXXXXX-XXXXXXXXXXXX-X--XXXXXXXXX-XXXXXXXf
------------------------------------------------------------------------------------------------------------------------XXX------o--XXXXX-BBXXXXXXXXXXXXXXX---XXXXXXXXXXXXXXXXXXXXXX--------XXXXXXXXXXXf
---------------------------------------------------------------------------------------------------------------------o-XXXX--------XXXXXX--XXXXXXXXXXXXXXXX--XXXXXXXXXXXXXXXXXXXXXXX-----B-XXXXXXXXXXXXf
----------------------------------------------------------------------------------------------------------------------XXXXX-o-----XXXXXTX-XXXTTXXXXXTXXXXXT-TXXXTXXTXXXXTXXXXTXTXTXT---T-TXXXTXTXTTXTTXf
---------------------------------------------------------------------------------------------------------------------XXXXXX------XXXXXX|XXXXX||XXXXX|XXXXX|X|XXX|XX|XXXX|XXXX|X|X|X|---|-|XXX|X|X||X||Xf
m-------------------------------------------------------------------------------------------------------------------XXXXXXX-----XXXXXXX|XXXXX||XXXXX|XXXXX|X|XXX|XX|XXXX|XXXX|X|X|X|--E|X|XXX|X|X||X||XX
XXXXXXXXXXXXXXXXXXXXXXXXXXXXXXXXXXXXXXXXXXXXXXXXXXXXXXXXXXXXXXXXXXXXXXXXXXXXXXXXXXXXXXXXXXXXXXXXXXXXXXXXXXXXXXXXXXXXXXXXXXXXXXXXXXXXXXX|XXXXX||XXXXX|XXXXX|X|XXX|XX|XXXX|XXXX|X|X|X|-M-|X|XXX|X|X||X||XX
