E-----|------------M-----------?X--Bo-------?-M----M----Xo----T--X?E----T--E----o-M--X-X---?-M|-T-B--------?-|--M---M-X-----X---EX------?-------|---|------X-XE---?------T------------T-TXT--M-----o---M
TX------M---?X-------B?-----|-----BE-----?------B-T-o----E----------------T--?M?-----------------------o------?E-TXTT-E-EM?--T-?---------?----|o----B-----------M--?M-|M-X---Mo--------B---B----BoE--E-o
?-----?---?-----X--------?EM-------M---M--B--B--------ME-X----M-B--------X--o-?--?-|--o-o-o-B-----------o----|--------?-B-o---------X-EX------o--------oM----M--------?-TX---E----------------ME--?B--oX
M?E-|----||-----B-T-XM-----|-----M--M--E---T--?-B-|--------X----?--|-----------------M-B--------M--o----?-T---?--ME-----?o--------------------E---------|--------o------E----------M--|------------X--XE
E---?-------X---|-?--E----------?--EB----?XM-|-E----|B-----B---o---B|-------TB----B-?--|----------------|--|-----------------TB----------M---|E-?----B----|--------o----o-XEB--------B-----------------o
o-o-?--oXX---o----T----T----B--o---BM--B?o----------X----T---------T-B---o-o-?--------------E-------E--?---Mo-B----ET--------------o-----X-M-----|----XX-----------?-----E---?----------B-----B----B-E-T
|-TE---E-----X-----|--MXB---------B---o-B--------------X|-----X----o|-T-o------------?---o--M--X---T---------?------X----------E---o--?--M-B--BX------?--T--|------------------BE----------------------E
M---|-?B----M----o-B-EB-BB-------TT-|M---------------X-M---------------M-----E-----B----------M------E--------B-X---T--E---|--M----M?---?--E----?-o-B--XB--T-B----------------------------|----o-|-----v
|----E----M--------B-M-EB|----M------o--------T---------|-MT?-T-E----T--o------T--X------T------|M-X----------M--B-|-------------------??T|-M-------------T---|Xo------------T----M---BXT------B-------?
E---------oE--X-E-----?--?--------?-B------------?-------------E-------T-?-M-X----oX---B-M?B----o-X------T---|-B------M------E-o----------E-o-o--------------------X--ET---X----Eo----o-----T--E?---B-B|
T--------X----o---M|--------?M-XE-----|?------X------BB----M------BTX----E------M-M?----X-----o|---------X-B----B--MX--|M?-B--------EE-o-----------------B---E---E--TT-------------M---------------|EX-|
B-----X--?-----TT---E--oX-----XM--?--|----T--M----XE--?----------E---X----o-X----------------|-------|------------E---T--X--------------X-XEBo-EM----------------?------X---B--?------EEE-------------B|
?-B--B--o-oM|--o----E----M-X-M--M-----------X--|--------------B?-------------?----------------MM----TTE-----------T-------o|---------TM----------M-X-----EME-??---T-oT---M--------BB-M--E---?--------|oT
E------?---------|--T-T-X-B-------------|------X---B----o--|--|--?-|-----------B-----B----o---------------M------?--E|-------?--?------To-------E-o-?-B--E-B?---T-|M?-X-----E------o----E--------------B
m-M--?-M------T--------?-----------?T-T--|XX-?|--B-E--|o--E----|-?-----------M-B---MMo---E--M--T-M?----|o|--------E-------o---X?-----X-M-----?T---B-X-BE|---|-E--------------EB----------|---EM-------oE
XXXXXXXXXXXXXXXXXXXXXXXXXXXXXXXXXXXXXXXXXXXXXXXXXXXXXXXXXXXXXXXXXXXXXXXXXXXXXXXXXXXXXXXXXXXXXXXXXXXXXXXXXXXXXXXXXXXXXXXXXXXXXXXXXXXXXXXXXXXXXXXXXXXXXXXXXXXXXXXXXXXXXXXXXXXXXXXXXXXXXXXXXXXXXXXXXXXXXXXX
