---------------------------------------------------------------------------------------------?--??????-----------o--------------o-----------------------------------------------?-----------------------
---------------------------------------------------------------------------------------------------------------------?-?---B---B-----------------------------------------------------------------?------
-----------------------------------------------------------------------------------------------------------------------?--------X----------------------------------------------------X-----XXXXXXXX-----
------------------------------------------------------------------------------------------?-------------X--------------------------------------------------X----------------------o------------X--------
--------------------------------------------------------------------------------------------------------------------?-BBBB-------X----------------------------X------------------------?---BBB--X-------
------------------------------------------------------M---------------o----------X-XXXX-----X----------B-------------X------------X--------------------------XX--------------------------------XX--????-
------------------------------------X-----------------------------------M------------X-----XX--?-------------o------XX-XXX-------XX-------------------------XXX--------------------------XXMXXXXX-------
-----X---------------------------------------------------o---X-----X-----------------XX---XXXB---X-----------------XXX---X--X---XXX-------BXXXXXXX---------XXXX----?----XX--------------X----XXXX---X--v
-----XX---------------------------------------------?--------XX---XX------------MX---XXX-XXXX----XX?--X-B-oo-----XXXXX---X-XX--XXXX-----------------------XXXXX-------------------------XX--XXXXX--XX--f
-----XXX-----------------------------------------------------XXX-XXX------------XX---XXXXXXXX????XXX--XX------M--XXXXX----XXX-XXXXX----------------------XXXXXX-------------------------XXXXXXXXXBXXX??f
-----XXXX--------------------------------------------X-------XXXXXXXX----X-----XXX---XXXXXXXX----XXXX?XXX------?XXXXXX---XXXXXXXXXX-B?X-----------------XXXXXXX------------BBBBBB-------XXXXXXXXXXXXX-Xf
-----XXXXX-------------?---------------------XXXXXXXXX-------XXXXXXXX---------XXXX---XXXXXXXX----XXXXXXXXX-----XXXXXXXo-XXXXXXXXXXX--XX----------------XXXXXXXX--------o----------------XXXXXXXXXXXXXXXf
-----XXXXXX------------------------------T---------XXXBBBTT--XXXXXXXX-TT-----TTXXX---XTXXXTXX--TTXXXXXXXXXT-TTXXXTXTTT-XXTXXXXXXXXX-XXX--X-----B------XXXXXXXXX-------X---o-------------XXXXTTXXXXXXTTXf
-----XXXXXXX-----------------------------|--------XXXX---||--XXXXXXXX-||----X||XXX--XX|XXX|XX--||XXXXXXXXX|X||XXX|X|||XXX|XXXXXXXXXXXXX-XX-----------XXXXXXXXXX------------------------XXXXX||XXXXXX||Xf
m----XXXXXXXX----------------------------|-E-----XXXXX---||-XXXXXXXXX-||---XX||XXX-XXX|XXX|XXX-||XXXXXXXXX|X||XXX|X|||XXX|XXXXXXXXXXXXXXXX-E------X-XXXXXXXXXXX-------------------E---XXXXXX||XXXXXX||XX
XXXXXXXXXXXXXXXXXXXXXXXXXXXXXXXXXXXXXXXXX|XXXXXXXXXXXXXXX||XXXXXXXXXXX||-XXXX||XXXXXXX|XXX|XXXX||XXXXXXXXX|X||XXX|X|||XXX|XXXXXXXXXXXXXXXXXXXXXXXXXXXXXXXXXXXXXXXXXXXXXXXXXXXXXXXX---XXXXXXX||XXXXXX||XX
