M?------X-E----Eo-----EoT|--?---BoXoX----------XX-M--B--BEB-X----Eo---BXME--XM---------o-----?B-To---X-BM------ET?E--??----|-BEBT-E----MoT--Mo?XX?-T----?---E-||X-?-?---B-E-X|-----T-T------?---E-M?---E
o----|-|-M---?-|M--M----X?--MBT?-?---?---X|-X---o-Eo-o------B-----|-?M-E--B----|T---ETooTXT-E-?E?E-BoEBo--B-oT|E-|--oo-MMoX-?ME-----?--T-EX--E---X-X-E-X-MT-MXM|-BM-T--?T?---o-----oX?o|-?-E-T-------?-E
M-E---TM--M--XBE|T?-Too|--E?B-o----M|-X-----------?----?o--|--M-T--X-XBM-?M--?B-X|E-ETo---TM---o------T-B-T--E-X---M-o-|--X-B------Bo?--T----B|-E----o?X--|?BX?--------?--B-?-TB?T----B---?B---|XEEM----
BT?M-TEX--?|-M--X-------o|--M|--o?--?---oX?-M-X--EMM----?--|--BM|--E-oB-|---T?-o-?---o---Moo-X-EM--ETX-oMo?E-T-B-|--?TBT-METToB--|ME---B--X--E--X-M|?oM--M--B-XE--E-?--|X---M?X-B----?---E----??TBX-X?oB
?M-oB--X---B-M---o-o-???-??--T----------B?M--MMX--------ET-----oB---oXM-EE----?--T---------B-M-M--X-||T-E-TX--|--MXT--XX-Bo-|--?|o-----B-EM---oE----E-?--TT--|BXo---X--------B-M-o--?--ETE-M-XT-|--?|-XM
|---EMEX?T----?|EE|MB-||XoMM-|-B-E--M-o-X-BE-o-|--XE-E--Xo---E--------|---------X?M--XEME-o-oM-X---X-E---MX--|X----EX--T|--X-o------XE----M|--T--XXB|----T-B----?BME-ETT--MT-MEBTM-M?E?-----EE--o-|T--Xo
M|-XT-?Xo---B-E-o|---E---o---o--ETMMMM--B--|XMME-Mo?---BBE----?--M---------?---TM-B---o--X----E|----?XToM-B---|-TE?---XBEMXT-E--M--?X---M-Eo?--XETM-o-T----EB-B---|----T-?ET-E--TMM-o----T-B?--M-BEX-M-|
o-MX---|X-?-|--T-TX-o--EoB---|T-|-|M--EM?-M|MB----|T-T-M|T?-----o-?--E|-EEET---o---?-X---E-BX--|||-----|?X-T--T?M|-T-|?-|-oBT-------B|oE--X---------BM----X-----------------B--BB----?-EX-XM-----M----Tv
|-M-E-TX|?--B--B|--EEo---M?|--M??--|M-MMX|M|-XB-|BoTE-|EE-|--|--X-BE----B-M--?---|--XX?o---EME-T?----o----M---M-B---XXTXB-M--TMoE-X--EX-o-E---E-o-----o-|-o-?----TX---TETBoTT-??ET----EXX---o--B----o--M
o--E-?-BEEB---B|o-TB-EB---E--BB-?XB--M-----|-o|-------X--|-?---BBT-M---M--M----M-M--T------?E-|---|-------EE---|--E------EM--oX-oX---o-?--------o------|-X--E?E--M---o|B---oXE-MMB?-X--oo?-BT-XE---E?MoX
|-oX----o??E---MTX-E----o-|EXXo--?---|--?EM--T---X-o-TXEB----T-M-XM-T?-E--o|E-------T-X----MTBo--M-|--oM--|o-?T-oME-|T-----XE--M|--BX----|--o-TX--EXB--B?-------?----oE-?-?--ooMT?oBMo-B------|M--o|T--E
EM---o-o--M---XToT--|--EMo-o----M-EX?M-T---E-BE--M--E-X-Eo-X?-EMB---?--M|TTTBo----T-MTT-o-----EB-o--XM??--Mo--E---B-T-|-o---?E---X-o-E|B?-o-----M--TEE?--?T---B----?-o-|---B---X?M|--XE-?-T-T---M--||o-M
X-M---T--T|B--oM--?---M---M-B--Too--X------B?||E---?---|--ToMooMMX---------?---?-E|--BEB?-B|----|-X-X-E--?M----o---B-M---EE-T--|-EX-M--B-BB-|------XTXT---?X|---TT--TTT------BB--T-X---Bo|T-Eo|o-|X----B
?B--X-|--M|-XE-T------|-----XM--|-BXE?|-E-ETMBB-------X-------ETB---XEoX---oT-X-B----T--EB-o?--o?-XM?-X---T-B--E-||M-E-|M---M-?E----|T------MX--E--T?--E|-?-----EM|-T--o--EMEoE|-MEB-----XME-oB--E-|--E?
m-o-M|---ToB|?-XB--M---XX|-o-E-------T---EX-----T--|B|?-|-XB-|?-XEM---|---?---XBB-XM-ooT-TE--M--oEE-oMMoT-X--oToMXo----T---M-o-E--E-|B-B---o----T-X|--?----?|-M-X-M-----|M|-E|-E-E--EM-E-B-XoB-B-----X?|
XXXXXXXXXXXXXXXXXXXXXXXXXXXXXXXXXXXXXXXXXXXXXXXXXXXXXXXXXXXXXXXXXXXXXXXXXXXXXXXXXXXXXXXXXXXXXXXXXXXXXXXXXXXXXXXXXXXXXXXXXXXXXXXXXXXXXXXXXXXXXXXXXXXXXXXXXXXXXXXXXXXXXXXXXXXXXXXXXXXXXXXXXXXXXXXXXXXXXXXX
