X|EXBMM?--T-|-B?--o-|----T|---T--??-o-X----oXo--o--T-?|-------TT---X|TET?-XXB?o--XoTE-MMX--BM--E---E--E-M--|XM?TX-BTM--X|--MBM--X--?--M-E-?M--M------o------X?-|-?Eo-|?o?---|?-M----E-----X-o-M-oX------
B--?--|-M-----MEo---T-TX-oBB--M---XMBo-?X-T----T|o-B--B-?E--B|-B-?--?E--E----??--M?---|--MT-XEo-T------?E-X-T-oM--B-B-XX?|---------o---|M-|-X|----BE--MEo-------T?--??-?-?----T--TM-----XX-E--|-M----B-T
MoMB-BEEB|-?Mo--B-E-o--T-?-----BB-T?--|----X--X---ETE----|----MB----EoXo-ME---E--T---T---?|---?X?-E---X---M-M|-B--X--oMX--?o-T---EXTB--X-X---T|ME---------?--XM|-o?-Xo--M-Bo---------E--oM-----B?------M
|--|-BB?---E-|-oE-------|-oBoE-B---M---?T---|-Mo----|--T?T----BoT?-oEE-E|-M?-T-M--XT-o--o-MBTM-B--BT??---------?T--|------|o---T|T----Moo---------B------MM-Xo--oo-E--|-B-----BMT---MT-o|?----E----|-TEX
X--||?E-X-o-TX--MMMMX|-o---EM-E-B-|E-o-EMo-T-M--B----BT---X---M--X------T---B-----?-----------|E----E----------o----|?M--BT-M-------EB----------T-T--------M-B--o--X-T----XEM|--||B-XX-X-----X-M-|o----M
-TT--B|-|---??--T-B-|-M--?B-----|-EM-XB--T---B|-B--EB--M-BE-BX---B-|o-B--M--|-------E-M-B--E-XME-MoX-MX---------o--MBMX-T--M-BB--MBo--MT-B--T-?B--X-B---T|-E|-o--oo---T--T-|-X---o-------B--oo-???o-o-B|
M|--B--B------E--M-B--|BE---ETBoB-||?-??|M--MX-||B--|o-TEEX-X---B-?-|?oMM|-?-|---oBoT-MM---X-BT--T|EXE--M-----B--o------MEM-|--?---B-MB-T?o--E-|-E-X-?-M-|XT-M-?----BMTXEX-?o-?B----o-----B----?-|---E--
T|--E---?--|-TT---X--|M?-|---E-T--ETE--||E--EE----T--------o-X---M---X--oM-M--o---M------?B----B-E--o-X?-----T--E?-ET---TX-o?TB--B--E------o|?--BM-?--MM--B-??-EX---|XB-B-BE-?--EX?-E|M|T---?-|-E|--BM-v
--BBBX-|-------?-o-E-ToBX-------|E---E--B----|-??XX----T-|-X---------E--Mo---E---M-M|-----T||-B-|-T?-EM-E----M---M-B|B-?Eo-?---||EM-?---|M---Xo-MX--------XE-----E---?TM--oX?-----?B--X---?|o---E-oBT--o
B----M-oX-T-E----T-X---T--X--o-MX||M|B--T-T-M--|o-|oXo-M--M----|BE---E|-|-?o--X-|---B----o-MB---o?-|-----o-TXB-??oTB-?--|M|-BoM?--X---ME----o--E-T-?-o-oTM-EB-o---oE|?-XM-?|-X----o-|-E-?-X---TEBoBo-B-B
-|-XB---TM|--To----EE--X--|oX-B-B--M?E----|B|---ME-----o-Xo-TMX--Mo?--T-M-X-M?B|-Mo--M----|----|-|-B?----X-oB--To?-B-E-M--?--T---E-MX?oEX---|?oB-|-?E-BMB---o--|--X---o|----X--ET---oT-M-B---MMM|MM----T
?o---?---XEoB---MTo-----M-E--|-M-|--?-|B-B|?E-M----M-|-T------oX-T-T-T--T--o|-EE?B-T-T--X-B-E-?T---X-E?M?--ET-MBEEXE------?Eo----o-T--?-E-B-Mo-MX-||-X-XM--XEE|-TEBoEXM-MTB-M-|---|EBE--XE----E|------BB
T---B-----oT---E--?-oX-BoX|-|M|EXBTE-?M-|-?-oo-|?-XE-?---o??---o----------T--B-----?------BTo-EMEX-|Mo--B----T-E-----M--X-E--E--E-o-T-T-?|--ET-T-T-E----|-|--B|EXE-o-EM-B?Bo-Bo---X--|T|X|BM-oX---T----?
|BE-|----|?-o----XB?-BooXE??-T|-B-|XBTXX|M---M-----?----X-----------B--X--o-|-----EoM-M-??ET------oo-oB-M-EM-X---------EoB--BM|----Bo---?--oB-o---|---?E-X-----E--?-?-XB---|-----TM---BBo---B?--BT---|-T
mX-XB?X-EX----T--?---XT--E--o-?--?oET---?M?------|EXE?T?-M---B-E-X--o-B-X-XB----B?ME----M-|---B-?---M--o---TT-X--?---------|--T-EX--T-M-T--|-|---?-ME-?-----BE---|M--?EE---X?--XTEoTT?T|EE-TT-|X-o-?M--X
XXXXXXXXXXXXXXXXXXXXXXXXXXXXXXXXXXXXXXXXXXXXXXXXXXXXXXXXXXXXXXXXXXXXXXXXXXXXXXXXXXXXXXXXXXXXXXXXXXXXXXXXXXXXXXXXXXXXXXXXXXXXXXXXXXXXXXXXXXXXXXXXXXXXXXXXXXXXXXXXXXXXXXXXXXXXXXXXXXXXXXXXXXXXXXXXXXXXXXXX
