------------------------------------------------------------------------------------------????????????-----------o--------------o-----------------------------------------------?-----------------------
-----------------------------------------------------------------------------------------------------------------------?-------B---------------------XXXXXXXX-----------------o------------------?------
-----------------------------------------------------------------------------------------------------------------------?-?------X----------------------------------------------------X-----XXXXXXXX-----
------------------------------------------------------------------------------------------?-------------X--------------XXXXXXX----------X------------------------------------------------------X--------
--------------------------------------------------------------------------------------------------------------------?-BBBB-------Xo----------------------------------------------------?---BBB--XX------
------------------------------------------------------M---------------o----------X-XXXX-----X----------B-------------X-------------------------------------------------------------X-----------XXX-????-
------------------------------------X-----------------------------------M------------X-----XX--?-------------o------XX-XXX---?-----------------------------------------------------XX----XXMXXXXXX------
-----X---------------------------------------------------o---X-----X-----------------XX---XXXB---X-----------------XXX---X--X-------------B------------------------?---------------XXX-------XXXXX--X--v
-----XX---------------------------------------------?--------XX---XX------------MX---XXX-XXXX----XX?--X-B-oo-----XXXXX---X-XX------------------------------------------------------XXXX-----XXXXXX-XX--f
-----XXX-----------------------------------------------------XXX-XXX------------XX---XXXXXXXX????XXX--XX------M--XXXXX----XXX------------------------------------------------------XXXXX---XXXXXXXXXX??f
-----XXXX--------------------------------------------X-------XXXXXXXX----X-----XXX---XXXXXXXX----XXXX?XXX------?XXXXXX---XXXX--------?X------------------------------------BBBBBB--XXXXXX-XXXXXXXXXXX-Xf
-----XXXXX-------------?---------------------XXXXXXXXX-------XXXXXXXX---------XXXX---XXXXXXXX----XXXXXXXXX-----XXXXXXXo-XXXXX--X-----XX--------------------------------------------XXXXXXXXXXXXXXXXXXXXf
-----XXXXXX------------------------------T---------XXXBBBTT--XXXXXXXX-TT-----TTXXX---XTXXXTXX--TTXXXXXXXXXT-TTXTXTXTTT-TXTXXX-XX----TXX--X--------------------------------T---T----XXXTXXTXXTTXXXXXXTXXf
-----XXXXXXX-----------------------------|--------XXXX---||--XXXXXXXX-||----X||XXX--XX|XXX|XX--||XXXXXXXXX|X||X|X|X|||X|X|XXXXXX---X|XX-XX--------------------------------|---|----XXX|XX|XX||XXXXXX|XXf
m----XXXXXXXX----------------------------|-E-----XXXXX---||-XXXXXXXXX-||---XX||XXX-XXX|XXX|XXX-||XXXXXXXXX|X||X|X|X|||X|X|XXXXXX--XX|XXXXX-E----E----------------------E--|---|---EXXX|XX|XX||XXXXXX|XXX
XXXXXXXXXXXXXXXXXXXXXXXXXXXXXXXXXXXXXXXXX|XXXXXXXXXXXXXXX||XXXXXXXXXXX||-XXXX||XXXXXXX|XXX|XXXX||XXXXXXXXX|X||X|X|X|||X|X|XXXXXXXXXX|XXXXXXXXXXXXXXXXXXXXXXXXXXX---XXXXXXX|XXX|XoX-XXX|XX|XX||XXXXXX|XXX
