------------------------------------------------------------------------------------------????????????-----------o--------------o-------------------------------------------M---------------------------
-----------------------------------------------------------------------------------------------------------------------?-------B---------------------XXXXXXXX------------------------------------?------
-----------------------------------------------------------------------------------------------------------------------?-?------X----------------------------------------------------X-----XXXXXXXX-----
------------------------------------------------------------------------------------------?-------------X--------------XXXXXXX----------X-------------------------------------BBBBBB--------------------
--------------------------------------------------------------------------------------------------------------------?-BBBB-------Xo---------------------------------------------------X?---------X------
------------------------------------------------------M---------------o----------X-XXXX-----X----------B-------------X---------------------------------------------------------------XX---------XX-?----
------------------------------------X-----------------------------------M------------X-----XX--?-------------o------XX-XXX---?------------------------------------------------------XXX--------XXX------
-----X---------------------------------------------------o---X-----X-----------------XX---XXXB---X-----------------XXX---X--X-------------B----------------------------------------XXXX-X-----XXXX-----v
-----XX---------------------------------------------?--------XX---XX------------MX---XXX-XXXX----XX?--X-B-oo-----XXXXX---X-XX-----------------------------------------------------XXXXX-XX---XXXXX-X---f
-----XXX-----------------------------------------------------XXX-XXX------------XX---XXXXXXXX????XXX--XX------M--XXXXX----XXX----------------------------------------------------XXXXXX-XXX-XXXXXXXXB??f
-----XXXX--------------------------------------------X-------XXXXXXXX----X-----XXX---XXXXXXXX----XXXX?XXX------?XXXXXX---XXXX--------?X-----------------------------------------XXXXXXX-XXXXXXXXXXXX---f
-----XXXXX-------------?---------------------XXXXXXXXX-------XXXXXXXX---------XXXX---XXXXXXXX----XXXXXXXXX-----XXXXXXXo-XXXXX--X-----XX----------------------------------------XXXXXXXXoXXXXXXXXXXXX---f
-----XXXXXX------------------------------T---------XXXBBBTT--XXXXXXXX-TT-----TTXXX---XTXXXTXX--TTXXXXXXXXXT-TTXTXTXTTT-TXTXXX-XX----TXX--X------------------------------------XXXXXXXXX-XXXXXTXXXXXX-X-f
-----XXXXXXX-----------------------------|--------XXXX---||--XXXXXXXX-||----X||XXX--XX|XXX|XX--||XXXXXXXXX|X||X|X|X|||X|X|XXXXXX---X|XX-XX-----------------------------------XXXXXXXXXX-XXXXX|XXXXXXo--f
m----XXXXXXXX----------------------------|-E-----XXXXX---||-XXXXXXXXX-||---XX||XXX-XXX|XXX|XXX-||XXXXXXXXX|X||X|X|X|||X|X|XXXXXX--XX|XXXXX-E----E------------E----------E---XXXXXXXXXXXXXXXXX|XXXXXX---X
XXXXXXXXXXXXXXXXXXXXXXXXXXXXXXXXXXXXXXXXX|XXXXXXXXXXXXXXX||XXXXXXXXXXX||-XXXX||XXXXXXX|XXX|XXXX||XXXXXXXXX|X||X|X|X|||X|X|XXXXXXXXXX|XXXXXXXXXXXXXXXXXXXXXXXXXXXXXXXXXXXXXXXXXXXXXXXXXXXXXXXX|XXXXXXXXXX
