--------------------------------------------------------------------------XXXXXXX--X----M--????????-----B---------o-------M-X---------------------------------------------------------------------------
--------------------------------------------------------------------o-------------------------?---------o----------?-B---------o-----o-------------------------o--------XX---?------XXXXXXX-------X-----
--------------------------------------------------------o-----------o-----M--------------?-----------------------------------M----------------------------------------------------------?-------------B-
-----------------------------------------------------------------------o----------------------o-------o-------T---------------------X-------------------------T--------------T----------BBBBBBBB--------
-------------T---------------------------------T---------------------------T------------------------T------X--|---------X------------M----------X-------------|--------------|---XXXBoXo--XTXXX---X-M---
-----o-------|---------------------------------|---------------------------|-------------------TXBT-|-----XX--|-----???XX???-B--------M--------XX-----------T-|--------------|--T--------XX|oX-X-XXB-XT-
-------------|---------------------------------|---------------------------|-------------------|XX|o|----XXX--|-------XXX-M-B-T---------------XXX-----------|-|-------------T|--|X-X----XXX|XXXXXXXo-X|-
-X-----------|---------------------------------|---------------------X-----|-o--------------BTB|XX|B|---XXXX--|------XTXX----o|M-T-T-X---X---XXXX-----------|-|-------------||--|--XT?-XXXX|XXXXXXX-XX|v
---X---------|---------------------------------|------?---X---------XX-----|------T--B------X|-|XX|X|--XXXXX--|-T---XX|XX-----|--|-|XX--XX--XXXXX-----------|-|T--------XXX-||--|--X|XXXXXX|XXXXTXXXXX|f
---XX--------|---------------------------------|----------XX-------XXX-----|?T????|--To----XX|-|TX|X|BXXXXXX--|-|XXXXX|XX----X|-X|-|XX-XXXXXXXXXX-----------|-||------------||--|--X|XXXTXX|XXXX|XXXXX|f
---XXX-------|---------------------------------|----------XXX-----XXXX-----|-|--?-|--|-?T-XXX|-||X|X|TXXXXXX--|-|-XXXX|XXT----|XX|X|XXXXXXXXXXXXX-----------|-||-BBBBB----M-||X-|--X|XXX|XX|XXXX|XXXXX|f
---XXXX------|---------------------------------|----------XXXX---XXXXX-----|-|--o-|--|-T|XXXX|-||X|X||XXXXTX--|-|XXXXX|XX|XT--|XX|X|XXXXXXXXXXXXX-----------|-||---------X--||-M|XXX|XXX|XX|XXXX|XXXXX|f
---XXXXX-----|---------------------------------|---------MXXXXX-XXXXXX----X|-|----|X-|-||XXXX|-||X|X||XXXX|XX-|-|XXXXX|XX|X|--|XX|X|XXXXXXXXXXXXX-----------|-||--------XX--||--|-XX|XXX|XX|XXXX|XXXXX|f
---XXXXXX----|---------------------------------|----------XXXXXXXXXXXX----X|-|----|XX|-||XXXX|-||X|X||XXXX|XXX|X|XXXXX|XX|X|X-|XX|X|XXXXXXXXXXXXX-----------|-||-------XXT-X||X-|XXX|XXX|XX|XXXX|XXXXX|f
mE-XXXXXXX---|---------------------------------|----------XXXXXXXXXXXX----X|X|E--E|XX|X||XXXX|E||X|X||XXXX|XXX|X|XXXXX|XX|X|XX|XX|X|XXXXXXXXXXXXX-------E---|-||------XXX|-X||--|XXX|XXX|XX|XXXX|XXXXX|X
XXXXXXXXXXXXX|XXXXXXXXXXXXXXXXXXXXXXXXXXXXXXXXX|XXXXXXXXXXXXXXXXXXXXXXXXXXX|X|----|XX|X||XXXX|-||X|X||XXXX|XXX|X|XXXXX|XX|X|XX|XX|X|XXXXXXXXXXXXXXXXXXXXXXXX|-||--o--XXXX|XX||-X|XXX|XXX|XX|XXXX|XXXXX|X
