------------------------------------------------------------------------------------------------??????--------------------------------------------------------B-----------------?-----------------------
-------------------------------------------------------------------------------------------------------------------------------------------------------------------------------------------????????-----
-------------------------------------------------------------------------------------------------------------------------------------------------------------------------MX----------X-----XXXXXXXX-----
------------------------------------------------------------------------------------------?-------------X-------------------------------------------------------------------?-BBBBBB--------------------
--------------------------------------------------------------------------------------------------------------------------------------------------------------------------------------X?---BBB--XX------
------------------------------------------------------M---------------o---------------------X---------------------------------------------------------------------????????--o------X-XX--------XXX-?----
------------------------------------------------------------------------M------------X-----XX--?-------------------------------------------------------------------------?X??????--XXXX--XXMXXXXXX------
-----X---------------------------------------------------o---X-----X-----------------XX---XXX----------------------------------------------------------------------?---BXXXX-------XXXX-X----XXXXX-o---v
-----XX---------------------------------------------?--------XX---XX------------M----XXX-XXXX-----??--X-------------------------------------------------------------X-----XXX-----XXXXXBXXB-XXXXXX-X---f
-----XXX-----------------------------------------------------XXX-XXX-----------------XXXXXXXX---------XX-----------------------------------------------------------XX-----XXXX---XXXXXXXXXXXXXXXXXXXB??f
-----XXXX--------------------------------------------X-------XXXXXXXX---------X------XXXXXXXX---------XXX------???????--------------------------------------------XXX-?---XXXXXBXXXXXXXXXXXXXXXXXXXX--Xf
-----XXXXX-------------?---------------------XXXXXXXXX-------XXXXXXXX---------XX-----XXXXXXXX---------XXXX-------------------------------------------------------XXXX-----XXXXXXXXXXXXXXXXXXXXXXXXXX-XXf
-----XXXXXX------------------------------T---------XXX----T--XXXXXXXX--T--X--TTXXT---XTXXXXXX--TT-----XXXXT----------------------------------------------------TXXXXX-----TXXXTXXXXXXXTXXTXXTTXXXXXTTXXf
-----XXXXXXX-----------------------------|--------XXXX----|--XXXXXXXX--|-----||XX|--XX|XXXXXX--||-----XXXX|X---------------------------------------------------|XXXXXX----|XXX|XXXXXXX|XX|XX||XXXXX||XXf
m----XXXXXXXX----------------------------|-------XXXXX----|-XXXXXXXXX--|---EX||XX|XXXX|XXXXXXX-||---E-XXXX|XX-E-----------------------------------------------X|XXXXXXXEE-|XXX|XXXXXXX|XX|XX||XXXXX||XXX
XXXXXXXXXXXXXXXXXXXXXXXXXXXXXXXXXXXXXXXXX|XXXXXXXXXXXXXXXX|XXXXXXXXXXXX|-XXXX||XX|XXXX|XXXXXXXX||XXXX-XXXX|XXXXXXXXXXXXXXXXXXXXXXXXXXXXXXXXXXXXXXXXXXXXXXXXXXXX|XXXXXXXX--|XXX|XXXXXXX|XX|XX||XXXXX||XXX
