---------------------------------------------------------------------?--------------------------?????------------?XX---?--------------?-----------------------------------------------------------------
--------------------------------------------------------------------------------------------------------M------------------------------------o-------------------------------------------?-----o--------
------------------------------------------------------------------------------------------------------------------o-----------------------o-------------------------------------------???---------------
----------------------------------------------------------------------------------------------------------------------------------------------------------------------------------------------------B---
-------------------------------------------------------------------------------------------------------------X?---M-----------o----------------------------------------------------------?------------X-
---------------------------------------------------------o------------------------------------------o-X--B--XX----XB-X--B----Xo---X--------X----------X---------------------BBBB----X------X--X------XX-
-----------------------------------------------------------------------------------------------MX-----XX---XXXX??XX---------XX---XX?-------XX--------XX-------------------------o---XX-----XXXX??X--XXX-
-----------------------------------------------------------------------------------------------------BXXX-XXXXXXXXX------M-XXXX-XXXXB---X--XXX------XXX-----------------------------XXXo---XXXX-XX-XXXXv
------------------------------------------------------------------------------------------------------XXXXXXXXXXXXXXBBBBBBXXXXXXXXXXX---XX-XXXX---XXXXX--------------------------X--XXXX--XXXXXXXXXXXXXf
-------------------------------------------------------------------X----------------------------X-----XXXXXXXXXXXXXXXX---XXXXXXXXXXXXXX-XXXXXXXX-XXXXXX-----------------------------XXXXX-XXXXXXXXXXXXXf
------------------------------------------------------------------------X---------------X----B-----X--XXXXXXXXXXXXXXXXX-XXXXXXXXXXXXXXX-XXXXXXXXXXXXXXX-----------------------------XXXXXXXXXXXXXXXXXXXf
--------X-----------------------------------------------------------------------XXXXXX--XX-------o-o--XXXXXXXXXXXXXXXXXXXXXXXXXXXXXXXXXXXXXXXXXXXXXXXXX---------------------------?-XXXXXXXXXXXXXXXXXXXf
------------------------------------------------------------------T------T------T----T--XXX--T------BXXXXXTXXXXTXXTTXTXXXTXXXTTXXXXXXTXXXXXXXXXXXXXXXXX----------------T-------T----TXXXXTTXXXXXTTXXTXXf
------------------------------------------------------------------|------|------|----|--XXXX-|------XXXXXX|XXXX|XX||X|XXX|XXX||XXXXXX|XXXXXXXXXXXXXXXXX----------------|-------|---X|XXXX||XXXXX||XX|XXf
m----o-E--------------------------------------X-------E-----------|--E---|??----|----|--XXXXX|-E---XXXXXXX|XXXX|XX||X|XXX|XXX||XXXXXX|XXXXXXXXXXXXXXXXX----------------|-----E-|-XXX|XXXX||XXXXX||XX|XXX
XXX--------XXXXXXXXXXXXXXXXXXXXXXXXXXXXXXXXXXXXXXXXXXXXXXX-X---XXX|-----X|XXXXXX|XXX-|--XXXXX|----XXXXXXXX|XXXX|XX||X|XXX|XXX||XXXXXX|XXXXXXXXXXXXXXXXXXXXXXXXXXXXXXXXX|XXXXXXX|-XXX|XXXX||XXXXX||XX|XXX
