-------------------------M------------------------------------BBBBBBBXXXXXBBBBBBB------------------------oo-------------o-----oo--------------------------------------------------------------o---------
----------------------------------o---------------------------------X-----------X---------------------BX---------------o--------------M---??????------XXXXXXX-------------------------------------------
----------------------------------------------------------------------------X-----?----?------------X---o----X---------BBB----------BBBBB---------BB-------------o-----------------X--------------------
----------o---------------------------------------------------------o--------M-----------B-T------X---T-----------M--------------------------------------------------------------------------T-------T--
--------------------------------o------------------------------oM--------------------?-----|-o--------|----o------???---M-X-X---T-o-T---------------------------------------------T----------|-------|--
----------------------------------------------T----------------------T--BBBB--------------T|-----XT---|-????????---X---T-XXXX---|---|---TMT--X-X---?-----T------------------------|---------X|-------|o-
----------------------------------------------|-----X----------------|---X----------X-X---||-----X|---|-----BXBBBMXX-T-|XXXXX-o-|---|-B-|-|-XXXX?--------|------------------------|---------X|-------|--
----------------------------------------------|-----XX-------------M-|--XX---------XXXX-BB||B-X--X|X--|------XX--XXX-|-|XXXXX---|T--|---|-|XXXXX---------|-------B----------------|---------X|X------|-v
----------X----------------------------o------|-----XXX--------------|-XXX------?-XXXXX---||T-XX-X|XX-|-----TXXXXXXXT|X|XXXXT--o||-X|---|-|XXXXX---------|---------------?--------|---------X|XX-----|-f
----------XX----------------------------------|-----XXXX-------------|XXXX----X--XXXXXX---|||-XXXX|XXX|T-M--|XXXXXXX||X|XXXX|-X-||XX|---|X|XXXXX---------|------------------------|---------X|XXX----|-f
----------XXX----------------T-------X--------|-----XXXXX----XXXXX---|XXXX----XXXXXXXXX-BB|||XXXXX|XXX||----|XXXXXXX||X|XXXX|XB-||XX|X?-|X|XXXXX---------|-------------T----------|---------X|XXXX---|-f
----------XXXX---------------|--T----XX-------|-----XXXXXX----------X|XXXX----XXXXXXXXX-XX|||XXXTX|XXX||X--X|XXTXXXX||X|XXTT|XX-||XX|XXX|X|XXXXX-------X-|-------------|----------|---------X|XXXXX--|-f
----------XXXXX--------------|BB|BBB-XXX------|--X-?XXXXXXX---X----XX|XXXX-BB-XXXXXTXXX--X|||XXX|X|XXX||XXXX|XX|XTTT||X|XT|||XXX||XX|XXX|X|XXXXX------XX-|-------------|----------|---------X|XXXXXX-|-f
----------XXXXXX-------------|-T|o---XXXX--M--|XXXX-XXXXXXXX-XX---XXX|XXXX---XXXXXX|XXX-XX|||XXX|X|XXX||XXXX|XX|X|||||X|X||||XXX||XX|XXX|X|XXXXX-----XXX-|-------------|----------|---------X|XXXXXXX|-f
m---------XXXXXXX--E----EE---|-||E---XXXXX-BE-|--XXXXXXXXXXXXXX--XXXX|XXXX-EXXXXXXX|XXXXXX|||XXX|X|XXX||XXXX|XX|X|||||X|X||||XXX||XX|XXX|X|XXXXX----XXXX-|--E-------XXX|X---------|--------BX|XXXXXXX|-X
XXXXXXXXXXXXXXXXXX--XBBXXXXXX|X||XXXXXXXXXXXXX|XXXXXXXXXXXXXXXX-XXXXX|XXXX-XXXXXXXX|XXXXXX|||XXX|X|XXX||XXXX|XX|X|||||X|X||||XXX||XX|XXX|X|XXXXXXXXXXXXXX|----XXXXXXXXX|XX-------X|XXXX--XXXX|XXXXXXX|XX
