---E-ET----X----T--oXX?XT-?TT|B-oBE--BTBXE-EB-------T---oT|-Eo-X--E-B-|oM---MX--X---|-B--?T-MM|--|---TTMXX-|-----E-oM----X-o-o--?-BM-X--------|-BXB|-M----------TB---|-----?oTT?ME-----oT----BXBo?---XX-
-M?M-T-EE--M-T---|E--?---XEo-BM---M---|---|--M--B-------X?-X-|?X|--||-|X-T---EE?-M-----T--T--?--?EE---BMMo?EE--?-X-?M--BBE?-M-M----TX-o---X------E--ToE-o-o-BM-?-o-TXX--MM--||-o-?-E----XB-----B---oTXE-
-?T-TB--MX----E-?----|--Eo|-EB-X---?T-BB-T?-o--T---E-Xo-o----B?-E---EM---oE-EBBT??MXB----X-X-M-----EE---T---?-|-ETB----M---o-|----E-BXMo-X?-------?-|o|?o|--o---|oB-B?TT-TE?B-E----E-----TX------?-E-B--
--M|--BBT-o-B--?oB?-?---ME|---B---------EEo-|-o--X---o--X|-|M---M------X---ME--o---|E----?-TTE---?o-MXM----MBT--?----E-E-B?-o-T--BMB?E?|E----o|MXoTM---M----M--T-B?M---M|--B-|BX--|---o----M?T--MB--?---
-o-o-|Boo-----E?B---?--M|-|--TE-o-o--M---?B--E------T--?--X--o-|-oE--oE-MB?-T-M-----|TX--MB--?-?|-M---|M-?-M-BoX--|-----B----T--M----o-E|--B--B-??-B--X-T---M--XEM---------?---|T?-E--MEX--X?--XTB---T--
------oXo-|BBXE---|--BE?E--?-XBT------?-B--B?--X----E-?-B--|-----|--M-----M-----B--T-X--XT----XE--o--T----T-|--T---|To-METEM---TM-Mo-Bo-oXB-o-Xo-T?BX----T?|-X--To-E-o-|---T-E|?----?o?---oX--------X---
------?XB----?BMX--B---|o--TXT----BX--?|---?o--oEo---MXToB-?|-?----?o--EB---?-?----|Xo--------MT-BTT--o-M-o--oTT-MT--?|--E--T-BM-o---?----TE--o-M?-TEB--B---oX--?---E?-?-X-E--M---MT--o|?-B-|M----B--EE-
-M-oo-|E-X----M-T---o--------MB--MM---B??-----MT?X--T--M-E?o---??E--M--?B-|M?---E-oB-?MoE-|-?E--o?---|-TE--X?---TM-?-M--?------MM---T-|M?---X--M-|X-X-BT-?MM---|-TE-|X------o--M-E---------T---BM---E--v
-?-T-E--B----?|o?-X-TMo-------E---o----??-XoTEX--BX-?-BE-?-o---B--B?-------E-TBM|TTB?-------B|---------o-o---?-M|-T---E?-T--?-X?--o---|-|---E-EToo--X--TX-B-E-ToX--o---B--E---XE-----||---M-Mo-?-o----?f
-EM--BX-T---?-?-|-B---E---|B--EX-|---Xo-B--oBBo--?-o---M-E-X|-?--E??---E--------|-o-oE-TE-----oE??oXX-X-oB--|M-B-B-B----?---EM--o-E----BXE--?--|---X?-----BBBBX--X----XEEM------?E--?--X----XX-----E---f
-|o--M??-M?o?-X---TM-o---||X?-----TBX-M--TX-X----------E-B-B-o--|-?o--|----BBo-MEo-------XE---XX-|-----E-ME--MM--T-o--o?-T---?--XM--XTME--|E----B---XoMEE-----MBM-o|T-|--BE?o---X|--T--o|-Xo-|-MoTT-B-|f
-X----M--o---o|-B-|-B-T|E--X---T?M---XT----?-BTTME?-|--|-----XE---?-T-----EE---E-TXX--??-o--???-MX----X?E-XE-|XE-M-?-EMB-M---E--M---o----oET--|----B---T--o--|--BBT-E-oM-|EEB?----EE--EX|XB-?|--T----ETf
--oo------X-?---T-MoT--oE-?-?--o-X--EET--?XB?-|-o-TE-TM-oBoM----TM---X--T--?--T-M-|---TT-|T-------X|Eo?|-T--BB?E-EToBMoX---EXM------?B--M-EE|-BXX|oT-TMXT-------BB|--EM-|BM||--TX?M-----BBE-B---------?f
-M-o--E-X-X|M-T-X---M--------o-EoM--o-EX-|-----oE-EoX|-XX--E-T?|-o|---E-oM-|-?-M-XMBMo-T--M|----XX-|-----X-EBBo?X-T-E--???E?--M--MB--MT-o-TMB--------X-----o-X?oT--?---X---|-X-E-X--oT-Bo---oM---T?-X-Tf
m|-BET|X--------B-M-XT?-|Eo-----?--Xo??--|o------B--?B--o---T---B|---?-XEM--E-M--?o--TM-E-----|-X--MX-----M---M|M---EoX--B-XE--B-XB--------XM----X?-?X--oEBB--??oM---|---T--------||?-------o|-ET----|-X
XXXXXXXXXXXXXXXXXXXXXXXXXXXXXXXXXXXXXXXXXXXXXXXXXXXXXXXXXXXXXXXXXXXXXXXXXXXXXXXXXXXXXXXXXXXXXXXXXXXXXXXXXXXXXXXXXXXXXXXXXXXXXXXXXXXXXXXXXXXXXXXXXXXXXXXXXXXXXXXXXXXXXXXXXXXXXXXXXXXXXXXXXXXXXXXXXXXXXXXX
