------M-----------o-------------------------------B-------------------------------------------------?---------------------------------------------------------------------------------------------------
------------------------------------------------------o-------------------o-------o---------------------------------------------------------------------------------------------------------------------
-----------XBBBBXX----?------------------------------B------o----------------------M------M------------------o-----------------------------------------------------------------M---o--------------------
-------------------XX---------------------------o----------------------------------------M--------------------------------------------------------------------------------------------------------------
----------------B----X-----BBBBBBBo-----------------------XX------------------------------------------------------------------------------------------------------------o-------------------------------
---XBoB-X-?---------XX----------------X-------------------XX----XXXo-M---------o-o----------------------------------------------------------------------------------------------------------------------
---XX?--XXX----XB-BXXXBBo---BBBBB----XX-------M----------XXX-------Xo----MX--------------------------------------X--------------------------------------------------------------------------------------
---XXX--XXXX--XXBBXXXX?B------------XXX----------X------XXXX-------XX-----XX--?----------------------------------XX-M----------?-----------------------------------------------------------------------v
---XXXX?XXXXXXXX-XXXXX-----X-----X-XXXXX---------------XXXXX-X-----XXX----XXX?XXXXXXXX-?--------X----------------XXX------X----------------------------------------------------------------------------f
---XXXXXXXXXXXXXXXXXXX-----XX----XXXXXXX--------------XXXXXXBXXBBB-XXXX---XXXX-XBBBBBB---X-----XX------XXXXX-----XXXX-----XX---------------------------------------------------------------------------f
---XXXXXXXXXXXXXXXXXXX---X-XXX---XXXXXXX-------------XXXXXXX-XXX---XXXXX--XXXXXXX--------XX---XXX----------------XXXXX----XXX----------BBBB---------X--------------------------------------------------f
---XXXXXXXXXXXXXXXXXXX-o-XXXXXX-XXXXXXXX------------XXXXXXXX-XXXX--XXXXXX-XXXXXXXX-----B-XXX-XXXX----------------XXXXXX---XXXX---------------B-----XX--------------------------------------------------f
---XTXXXXXXTXTXTXXXXXTT--XXXXTXXXXXXXXXX----------TXTXXXXXTX-TTXXX-XXTXXXXXXXXTTXXX-T-T--XTXXXXXX-----T------T---XXXXXXX--XXXXX-------------------XXX--------------------------------T-----------------f
---X|XXXXXX|X|X|XXXXX||XXXXXX|XXXXXXXXXX----------|X|XXXXX|X-||XXXXXX|XXXXXXXX||XXXX|-|--X|XXXXXX-----|----o-|---XXXXXXXX-XXXXXX-----------------XXXX--------------------------------|------M----------f
m--X|XXXXXX|X|X|XXXXX||BEXXXX|XXXXXXXXXX--------XX|X|XXXXX|X-||XXXXXX|XXXXXXXX||XXXX|E|X-X|XXXXXX-----|------|-E-XXXXXXXXXXXXXXXXE--------------XXXXX--------------------------------|----------E------X
XXXX|XXXXXX|X|X|XXXXX||--XXXX|XXXXXXXXXXXXXXXXXXXX|X|XXXXX|X-||XXXXXX|XXXXXXXX||XXXX|X|XXX|XXXXXX-----|------|--XXXXXXXXXXXXXXXXXXXXXXXXXXXXXXXXXXXXXXXXXXXXXXXXXXXXXXXXXXXXXXXXXXXXX|XXXXXXBXXXXXXXXXXX
