-----------------T-------------------T-|-T-------------T-----T------------------------------------------------------------------------------------------------------------------------------------------
--X-----------T----------------X------------------------------------T--------------------------------------------------------------------------------------------------------------------------X-----E--
-----E---------------------------E------------------------------------------------------------------------------------------------------------X----------------------|------------T---------------------
--------------------------E------------------------------------------------------E----------------T------------------o--X------------------|X---E--------X--o----------------------------------|---o----
--------o------T---o-------------------------|--X----------------------------|------------------------------------------------E--------X--------T-------------------------------------------------------
----E----|-------E-----------------------------------------------X---------E--------------------------------------------E-------------------------------------E------|--------------------------|-------
-------T--o--o--------T-----|o---X----------X---------------E--------------------------------o-------------------|--------------------------------------X------------------X----X-----------------------
---|---------E-----------------o--------o-------E-E-----------T--o------------------------------------o---------T---------T-------E-------------|-------------------|----------------------------------v
------------------------o----------E----------------------------o-----|-------------T-------------|-------o---------o-------------------------T--E------E-------------------o-------------------------Tf
---------------------------------------------------------------E----------------------------------------------o---X------------------------------------------------------------------------------------f
--o---------------------------------------------------------------------------------------T-------------E----T-----------------------------------------------------X--------------------------------o--f
------------------------------|--------E--------|----X--------------X---------------E------------------------------------|--------o--------------o-----------------------------E-----------------------f
---------------------o-o-----o----T----------E--------------X--------E-----------------o--EE---------------------------------------X-------------------------------------------------------------------f
-----------------o|-----------------T------T-----------------o-------------------o-----------|------|---------------|-----------------------------T------------------X--------------------------X------f
m------------------------------------------------------------------------------------------------------------------------------------------------------------------------------------------------------X
XXXXXXXXXXXXXXXXXXXXXXXXXXXXXXXXXXXXXXXXXXXXXXXXXXXXXXXXXXXXXXXXXXXXXXXXXXXXXXXXXXXXXXXXXXXXXXXXXXXXXXXXXXXXXXXXXXXXXXXXXXXXXXXXXXXXXXXXXXXXXXXXXXXXXXXXXXXXXXXXXXXXXXXXXXXXXXXXXXXXXXXXXXXXXXXXXXXXXXXX
