---------------------------------------------------------------------------------------------o------------------------BBBBB-----------------------------------------------------------------------------
-----------------------------------------------------------------------------------o---------------------------o------MX--M-----------------------------------------------------------------------------
--------------------------------------------------------------------------------------------------------------M----------------------o------------------------------------------------------------------
-----------------------------------------------------------------------------------------------------------M--------o------------oo---------------------------------------------------------B-----------
-------------------------------------------------------------------------------------------------------o----------------------o----------------------------------------------------------------------X--
--------------------------------------------------------------------------------------------------------------------------?M--o-------o--------o-------------------------------------------------o--XX--
-------------------------------------------------------------------------M---------------------------------X-------------------o-------------------------------------------------------------------XXX--
----------------------------------------------------------------------------------------------X------X---o-X----------------------XX--B-----------------------------------------------------------XXXX-v
---------------------------------------------------------------------------------------------XX--X---XXMBBXX-------------------B-XX---o----------------------------------------------------------XXXXX-f
---X--------------------------------------------------------------M-------------------------XXX-XX---XXX-XXX----------------B---XXX-------------------X-----------------------------------------XXXXXX-f
---XX----------------------------------------------------------------M---------------------XXXXXXX---XXXXXXX----------XXX------XXXX------------------XX----------------------------------------XXXXXXX-f
---XXX------------------------------------------------------------------------------------XXXXXXXX---XXXXXXX----------------?-XXXXX----------X------XXX---------------------------------------XXXXXXXX-f
---XXXX----------------------------------------------------------------TT--------TT----T-XXXXXXTXXT--XXXTXXX?-------T--------XXXXXX--TT--X--TXX-XX-XXXX--------------------------------------XXXXXXXXX-f
---XXXXX---------------------------------------------------------------||--------||-XXX|XXXXXXX|XX|--XXX|XXXX-------|---o---XXXXXXX--||--XX-|XXX-XXXXXX-------------------------------------XXXXXXXXXX-f
m--XXXXXX---------------------------------------------------E-E--------||--------||----|XXXXXXX|XX|XXXXX|XXXXX------|----E-XXXXXXXX?-||--XXX|XXXXXXXXXX------------------------------------XXXXXXXXXXX-X
XXXXXXXXXXXXXXXXXXXXXXXXXXXXXXXXXXXXXXXXXXXXXXXXXXXXXXXXXXXXXXXXXXXXXXX||XXXXXXXX||XXXX|XXXXXXX|XX|XXXXX|XXXXXX--o-X|X----XXXXXXXXX--||XXXXX|XXXXXXXXXX-----XXXXXXXXXXXXXXXXXXXXXXXXXXXXXXXXXXXXXXXXXXXX
