----M---T---|--MMX--M-o---E|E-X?-o--TM--o---M|-T-M-X----||-T-TX--------?|-E-X-----E-o--E-M--EXMM---B?----E---|EXTMM--T-EM-?-o?B---XXT-XT------|-?-?BTET--o------X-B-M-MEB|--T?--M---|----M------?-o-?|E-
-TX|Bo-----X?oB-|E--?X-M-T-|T---XXM--------o--B|B---E----E--BE----B-EM--M----|---|X-E-|----o---TMB---E--TBB-T-|--X--o----|E--?-|o-o-------?-----M----?--M--T-|-----|-TT----------E-------o-XT-?BoX?EE---
-----?XT----|-BE--B-o--MX---B-?-T-M-?MB---|E--|oo-??---XM-E-?T|?T----XT-X---TX-----?------M-M-M--M----TE---M-T-EB|BB--E-XME--|------------EXT-?B----E-|||-oXMM--E-B-Eo--|oT-X------X?-M--XX-?|--X-T-----
--|-EBM-X-E----E-|?M-?---o----M|oE|B----M--oB--B-?------E---X-?-M-B-?TT-oE---B-T-T-----?-XoE---------|---E----|E-BT-M-oTM------X---X-|--?-------XTB--E-?--M--M-EBoM--XEM---|-TT--?B-X--E-----ToB?-T-EM--
--B--ME-E---EMT--o?TT--M--?-BB-MB-Xo-?-ET-X||X?E--E---?--T-----|--oM|BTM||-BT---M|T-B-|-ME--TM-T--o-MEX---oBT?-M-o--X-Bo-MXT--BMXE----X--??-o-TX---o--T-|----?--M-M|------B--oE--|--------T-?-B?-E|-T|--
-?--X---E-?--M|----MB---EB?---o-M----o-o-X---BT|M-|?oT-M?-|T??TM------E--T--o----||------|M----TX-----E----X-E----oM-|-----XBX-?-B-|-------?-XT?-?---------E--X--M-X---E-E---oEB------ET-B|-T?--M---E-?-
-o--XM|---X-B-----To-----BE--B--B-----TBX--o-TT-E--E--MBBB----|X---X|XTE-?-----?E-Mo---|--B-X-|---|---??------o--T----EEEB--E-B-T-?--E------?-----?---XX|------T-EB-T--X--|M?-----X--MM-T--o----B||--T--
---o-T-B--ETo--?-M---Eo--MMB-E--T-B-E---?o--TM--|T?-T---B----?B?-|-------------To-|-----XB---?---o---|-------T-ETX--MoBB--?-?---?------E----B-o-B--M-M-BET-X?-oT----?-B-oBEB?--|--M||--T--BE-Eo-T|MT---v
-----|----Eoo--------T----T--MM--o-o--TM?X-Mo---o|B----T-T------EE----o-?---BB---|MTT|-o--B--|-?-B|BTTT?-o--?-----BT----MT------T|Bo-----o---BM----B-B-oEXo-|T--M--M-------B-oo?B--o-XM----o-X-|ET-----f
-E?X---------M-?-|?E-oB-?E----BX------oE-?-|--------X-oT-o--?-BM--|--X--B-BB-X-Xo|BT-M?-XMBM---E|-MEE--|---o-o---oM---oMoT|-?o-T-E---BT--TBo-X----------X-oo-B---ET-?-M--||-------XXEB|X-E-?--M--|---|-f
---o--MB---|---E-M-M--M?--??X??--M----X----M--o-|?--------XB-X--o--B?-|-o-o----B-B?M---EB------X--B---EM-------oEX-X-||-B----oB---X---T-T--E-T--o----?|-?-B--XTE?-o-T---B-BM---?o-X?------o----?MX|-X--f
-X-?-|Eo--B--E-X--XEXo-T-Mo--XX-|?-X------oMB-T----Eo|?E-----BM---T|-?-B-B--B-|M-|----M-B--?B-?o------EoE-------T-M-X--|--?---T-?--EM---|-BTXM-XMX-B-E|B--M---M---|-----X--BX--Eoo----XX-B-EE---o---BB-f
-|-?X--M-TBB-----T-EX--?---M|-----?T-BXT?--?-?|BTMX-E--X?X-------T-|oE-X-X-B--X---T--?|-------?-M|TBB-o---T-BM----------oM-|-EE----|--BM?-MT-X-o-E?oM-?EoBB--MB?--|-ME|BB-|-BB---|X-T-EE-----EM--T??X--f
---BM-B---?-MT-?-|-B----T-EE--M--T------M--TB-------|T-----?-?ooBB|-X--B-------M--EM---T--??M--------BB--oo--EE-B----?---M-T-----?o-X---MT-?----X--Mo------T-E---X-oBB|-M--?X-Bo-?EE?o--T?XB------BE-Bof
m-E--B--M--Xo-E-|M--E----TXooT--?-----B-|-T-|M--T--?---------?B------|?-|---MBEE-?--oMX-M-o--o----oB-o---EM--M---B--X-?MXT-----X--M--o-----|---o--?-M-E--|----M--?----------|--BM---XX-ME----||-----?XEX
XXXXXXXXXXXXXXXXXXXXXXXXXXXXXXXXXXXXXXXXXXXXXXXXXXXXXXXXXXXXXXXXXXXXXXXXXXXXXXXXXXXXXXXXXXXXXXXXXXXXXXXXXXXXXXXXXXXXXXXXXXXXXXXXXXXXXXXXXXXXXXXXXXXXXXXXXXXXXXXXXXXXXXXXXXXXXXXXXXXXXXXXXXXXXXXXXXXXXXXX
