--------------------------------------------------------------------------XXXXXXX--X----M--????????-----B---------o-------M-X------------------------------------??----------X------------------o-------
--------------------------------------------------------------------o-------------------------?--------------------?-B----------------------------------------oo----X----XB-o?--------------------X-----
--------------------------------------------------------o-----------o-----M--------------?-----------------------------------M------------------------------------?????-----------------?-------------B-
-----------------------------------------------------------------------o----------------------o---------------T------------------------------------------T---BTBBBB?B--------T-XXXXXX---BBBBBBBB--------
-------------T---------------------------------T---------------------------T------------------------T------X--|---------X--------------------------------|-T--|----XXXXXXXX--|--?XXXBoXo--XTXXX---X-M---
-----o-------|---------------------------------|---------------------------|-------------------TXBT-|-----XX--|-----???XX???----------------------------?|?|??|----------XX--|--T--------XX|oX-X-XXB-XT-
-------------|---------------------------------|---------------------------|-------------------|XX|o|----XXX--|-------XXX-B-B----------------------------|-|??|??-------XXX-T|--|X-X----XXX|XXXXXXXoXX|-
-X-----------|---------------------------------|---------------------X-----|-o--------------BTB|XX|B|---XXXX--|------XXXX------------X-------------------|-|--|-----???XXXX-||--|X-XT?-XXXX|XXXXXXXXXX|v
---X---------|---------------------------------|------?---X---------XX-----|------T--B------X|-|XX|X|--XXXXX--|-T---XXXXX-----------XX-------------------|-|o-|T---o-?XXXXX-||--|XXX|XXXXXX|XXXXTXXXXX|f
---XX--------|---------------------------------|----------XX-------XXX-----|?T????|--To----XX|-|TX|X|BXXXXXX--|-|XXXXXXXX----------XXX-------------------|-|--||XT???XXXXXX-||--|XXX|XXXTXX|XXXX|XXXXT|f
---XXX-------|---------------------------------|----------XXX-----XXXX-----|-|--?-|--|-?T-XXX|-||X|X|TXXXXXX--|-|-XXXXXXXT--------XXXX-------------------|-|BB||X|BBXXXXXXXX||X-|XXX|XXX|XX|XXXX|XXXX||f
---XXXX------|---------------------------------|----------XXXX---XXXXX-----|-|--o-|--|-T|XXXX|-||X|X||XXXXTX--|-|XXXXXXXX|XT-----XXXXX------------------M|-|T-||X|XXXXXXXXXX||-M|XXX|XXX|XX|XXXX|XXXX||f
---XXXXX-----|---------------------------------|---------MXXXXX-XXXXXX----X|-|----|X-|-||XXXX|-||X|X||XXXX|X--|-|XXXXXXXX|X|----XXXXXX-------------------|-||X||X|XXXXXXXXXX||--|XXX|XXX|XX|XXXX|XXXX||f
---XXXXXX----|---------------------------------|----------XXXXXXXXXXXX----X|-|----|XX|-||XXXX|-||X|X||XXXX|X--|X|XXXXXXXX|X|X-TXXXXXXX-------------------|-||-||X|XXXXXTXTXX||X-|XXX|XXX|XX|XXXX|XXXX||f
mE-XXXXXXX---|---------------------------------|----------XXXXXXXXXXXX----X|X|E--E|XX|X||XXXX|E||X|X||XXXX|X--|X|XXXXXXXX|X|XX|XXXXXXX--------------E----|-||-||X|XXXXX|X|XX||XX|XXX|XXX|XX|XXXX|XXXX||X
XXXXXXXXXXXXX|XXXXXXXXXXXXXXXXXXXXXXXXXXXXXXXXX|XXXXXXXXXXXXXXXXXXXXXXXXXXX|X|----|XX|X||XXXX|-||X|X||XXXX|XXX|X|XXXXXXXX|X|XX|XXXXXXX-XXXXXXXXXXXXXXXX--|-||-||X|XXXXX|X|XX||XX|XXX|XXX|XX|XXXX|XXXX||X
