--------------------------------------------------------------------------XXXXXXX--X----M--????????-----B---------o-------M-------------X------------------------??----------X------------------o-------
--------------------------------------------------------------------o-------------------------?--------------------?-B--------------------------------------X-oo----X---XX?-o?------XXXXXXX-------X-----
--------------------------------------------------------o-----------o-----M--------------?------------------------------------------------------------------------????XXXXXX----------X-?-------------B-
-----------------------------------------------------------------------o----------------------o-------o-------T------------------------------------------T-?-BTBBBB?B--------T-BBBB-----BBBBBBBB--------
-------------T---------------------------------T---------------------------T------------------------T------X--|---------X--------------------------------|-T--|----XXXXXXXX--|--?XXXBoXo--XTXXX---X-M---
-----o-------|---------------------------------|---------------------------|-------------------TXBT-|-----XX--|--------XX-------------------------X------|-|T-|----------XX-X|--T-------BXX|XX-X-XXB-XT-
-------------|---------------------------------|---------------------------|-------------------|XX|o|----XXX--|-------XXX-B----------------------------T-|-||?|??-------XXXXT|--|X-X----XXX|XXXXXXXoXX|-
-X-----------|---------------------------------|---------------------X-----|-o--------------BTB|XX|B|---XXXX--|------XXXX-----------------------------o|-|B||B|B----???XXXXX||--|X-XT?-XXXX|XXXXXXXXXX|v
---X---------|---------------------------------|------?---X---------XX-----|------T--B------X|-|XX|X|--XXXXX--|-T---XXXXX--------------------------T---|-|-||-|T---X-?XXXXXX||--|XXX|XXXXXX|XXXXTXXXXX|f
---XX--------|---------------------------------|----------XX-------XXX-----|?T????|--To----XX|-|TX|X|BXXXXXX--|-|XXXXXXXX--------------------------|o--|-|-||-||XTXX?XXXXXXX||--|XXX|XXXTXX|XXXX|XXXXT|f
---XXX-------|---------------------------------|----------XXX-----XXXX-----|-|--?-|--|-?T-XXX|-||X|X|TXXXXXX--|-|-XXXXXXXT-------------------------|---|-|X||T||X|XXXXXXXXXX||X-|XXX|XXX|XX|XXXX|XXXX||f
---XXXX------|---------------------------------|----------XXXX---XXXXX-----|-|--o-|--|--|XXXX|-||X|X||XXXXTX--|-|XXXXXXXX|-------------------------|---|X|X|||||X|XXXXXXXXXX||-M|XXX|XXX|XX|XXXX|XXXX||f
---XXXXX-----|---------------------------------|---------MXXXXX-XXXXXX----X|-|----|X-|--|XXXX|-||X|X||XXXX|X--|-|XXXXXXXX|-------------------------|---|X|X|||||X|XXXXXXXXXX||--|XXX|XXX|XX|XXXX|XXXX||f
---XXXXXX----|---------------------------------|----------XXXXXXXXXXXX----X|-|----|XX|-X|XXXX|-||X|X||XXXX|X--|X|XXXXXXXX|-------------BBB----T----|--X|X|X|||||X|XXXXXTXTXX||X-|XXX|XXX|XX|XXXX|XXXX||f
mE-XXXXXXX---|---------------------------------|----------XXXXXXXXXXXX----X|X|E--E|XX|XX|XXXX|E||X|X||XXXX|X--|X|XXXXXXXX|--------------------|----|EXX|X|X|||||X|XXXXX|X|XX||XX|XXX|XXX|XX|XXXX|XXXX||X
XXXXXXXXXXXXX|XXXXXXXXXXXXXXXXXXXXXXXXXXXXXXXXX|XXXXXXXXXXXXXXXXXXXXXXXXXXX|X|----|XX|XX|XXXX|X||X|X||XXXX|X-X|X|XXXXXXXX|---XXXXXXXXXXXXXXXXM|XXXX|XXX|X|X|||||X|XXXXX|X|XX||XX|XXX|XXX|XX|XXXX|XXXX||X
