-------T----XE--?EE---X|--B---T-|-----T-----------o--o--?----------|----X?---BX---------------o--o---------M---M|-----T---|?---?--oB----E?---------B------E---M--B----X------E?----BB-T--E---E|--M-X----
-|---------|-----------?-----M-B-------B|M----------B------|---------M-o--?----B------------|-----------Eo----------T-E----T-?-----M|------Mo---|-----?T------X-Mo-------??-?---E--------|-M---?ETEo-E--
--------o--------B---E--E------------XBM--------M---X-------o-----?------M--------?---MM--|-------------X---B--?-M-----B-TM----|-|-X-M----T---?-----MM-X-B-?--|-----------------T----------|--?----B--|-
-o-X-o------?-T----|---B|----X-X------EE-o-------?-----T?-------?-?---------------X--|-E---------B-E-E-----------T---?-------|------------T?---------T-----------B---------|M--------T|---------------?-
------?M-o|T---X--?-------|----?-?-----?---------------o--------E-T-----o--M----------------E?T-B-------XB---E-TXB------------oT------E-------------M-|--X--------T------?---T-------B---?||--E--o-o-|T-
-----XX--B---B--o-B---T|----------E--T---------o-E----oX----B----|-o---------M---|-E|-T----B----B-------?-?---B-----E-----o-To---------E-------|X------?-----o-T----X----E--E-----M-------T-----o-------
---------|-?--B----|-|----T-|--M------------?-T-----o--Bo---BT-|-----------------TT---o-----------------------?----X----o--B--E-X-?--?--------------T---MX---------T----E---X----M--|o-----------MT-----
--XM----?---------------TX--MT---E-T-oE?-B----BM--------X---?--B--------M--?X-BE-----B?---------EX?B-|-X--|------?-------------?------oB-E---X?B---?-T----M------M------------E-----------B--M|-------Tv
--M--M-----------?E-----E--M--MB----------------?T?--B-M-----||-TE-|-------------------?-Xo-----T-------|--B---B-B-MM------------M-T--|----X-----M-----X----E-E----T---------------?-------------E----Ef
-M----?--BX--E-?-TT-------X---E---E-----T----BB--B------------E-----E?-o|-?--M------o-Bo?-T--B--M-------E-|-o-----E--?-o--------T-----------|------------T--B--------------M----------------T-E?----X?-f
-M--o--------T|-----o---M---T-M-?--------------X-EEEo--B-------------E---|--------X---?--E-X---B-X------------M-BB------|o---E?-----X?----?--EB-E-----T---T-----X-T-B---B-------E---TX-----M-T----?--|Mf
--------------?-------B--------T--oT?E-X-o---?------E-----------E----?|T---X-------o?-----M------X--EM--|--o-------------X|--TM------------T-B-B--o-T----B-T-|-|-o----T-----|X---T-X----o---B--EE-T-|-Xf
---BT--?-------|---T--E-----------------B-E-E-B---M-------X---|------M--XT-----T--------------T----BB----E----X--o----BX-----------T------------o-------?-M-----------o-M--T----X|M--T----X----------?Xf
-X-T--|-E------o-|-------|------------XX-MB-|-|-?|-----------------oM-B--E----------XB----o?-T----o?X----------T------------------E---|-|-----X-----MTE-?T--o|-----EM-BT--------------E-----??X---B-T--f
m-o-------------o------|-E------------M----B---E--?--T--B-?-----M-o----------B--------------------o------TB-|-----|-----------|---------o------T-B------------o--?---EE--?-----B-M--?---BE----E--E-B---X
XXXXXXXXXXXXXXXXXXXXXXXXXXXXXXXXXXXXXXXXXXXXXXXXXXXXXXXXXXXXXXXXXXXXXXXXXXXXXXXXXXXXXXXXXXXXXXXXXXXXXXXXXXXXXXXXXXXXXXXXXXXXXXXXXXXXXXXXXXXXXXXXXXXXXXXXXXXXXXXXXXXXXXXXXXXXXXXXXXXXXXXXXXXXXXXXXXXXXXXX
