---------------------------------------------------------------B-------------------------------------------------------------------------------------------o-X------------------------------------------
-----------------------------------------------------------------------------------------------------------------------------------------------------------oXXXXX-----o-MBBBBM---------X------???????---
--------------------------------------------------------------------------------------------------------------------------------------------------------XXXXX-------B----------BBBB--B-------oX--o-M----
-------------------------------------------------------------------------------o---------------------------------------------------------------------------???-----X-?????--------------------------oo--
--------------------------------------------------------------------------------------------------------X-------------------------------------------M---------------????????X---------------------------
----------------------------------------------------------------------------------------X--------------XX---------------------------------------------B-----------X-----X--XX------X----BBBXXXXXX-XX--X-
------------------------------------------------------------------------X---------BB--------------X---XXX--------------------------------------------------------XXXX--XX-XXX-o----XX---XX----XXXXXXX-X-
---X-----------------X--------------------------------------------------XX--------------X--------XX--XXXX--------------------------------------------?????----o-XXXXX-XXXXXXX---XXMXXX-XXX-o--XXXXXXXXXv
---XX---------------XX-----o--------------------------------------------XXX------------XX-------XXX-XXXXX---------------------------------------------------X--XXXXXXXXXXXXXX-o----XXXXXXXX---XXXXXXXXXf
---XXX-------------XXX--------------------------------------------------XXXX--M-------XXX------XXXXXXXXXX---------------------------------------------------XXXXXXXXXXXXXXXXX---X--XXXXXXXXX--XXXXXXXXXf
---XXXX-----------XXXX--------?-----------------------------------------XXXXX--XXXXX-XXXX-----XXXXXXXXXXX---------------------------------------------?-----XXXXXXXXXXXXXXXXX----XXXXXXXXXXXX-XXXXXXXXXf
---XXXXX---------XXXXX-------------------------------------------XXXXXXXXXXXXX------XXXXX----XXXXXXXXXXXX------------------------------------------X--------XXXXXXXXXXXXXXXXXX-----XXXXXXXXXXXXXXXXXXXXf
---XXTXXX-------XXXXXX----------------B-----------T--------------T--T---XXXXXXX----XTXXXX-BBXXXXXXXXXXXXX------------------------------------------XX------XXXXTTTXXXTXTXXXXXXXTT-XTXTTTXXTTXXXXTXXXXXXf
---XX|XXXX-----XXXXXXX----------------------------|--------------|--|---XXXXXXXX--XX|XXXX--XXXXXXXXXXXXXX------------------------------------------XXX----XXXXX|||XXX|X|XXXXXXX||XX|X|||XX||XXXX|XXXXXXf
m--XX|XXXXX---XXXXXXXX--------E-------------------|--E-----------|--|---XXXXXXXXXXXX|XXXXEXXXXXXXXXXXXXXX------------------------------------------XXXX--XXXXXX|||XXX|X|XXXXXXX||XX|X|||XX||XXXX|XXXXXXX
XXXXX|XXXXXXXXXXXXXXXXXXXXXXXXXXXXXXXXXXXXXXXXXXXX|XXXXXX-XXXXXXX|XX|---XXXXXXXXXXXX|XXXXXXXXXXXXXXXXXXXXXXXXXXXXXXXXXXXXXXXXXXXXXXXXXXXXXXXXXXXXXXXXXXXXXXXXXX|||XXX|X|XXXXXXX||XX|X|||XX||XXXX|XXXXXXX
