-------------------------M------------------------------------BBBBBBBXXXXXBBBBBBB------------------------------------------------------------------------------?---------------------------o--o---------
----------------------------------o---------------------------------X-----------X---------------------------------------------------------??????---o--XX?XXXX-------X------o-?????-M---??????-----------
----------------------------------------------------------------------------X-----?----?------------o--------------------------------B------------BBX-----o------ooo---------------X-----------XXXXXX-o-
----------o---------------------------------------------------------o--------M-----------B-T------X---T----------------------------------------------------------------o-o-------X-T-----M---T-----o-T--
--------------------------------o------------------------------oM--------------------?-----|-o--------|-------------------------T-o----------------------B-----X------------------T|--XB--Xo-|---XX?X|--
----------------------------------------------T----------------------T--BBBB---------------|-----X----|-------------------------|--------B---B-----?????-T----XX-?------X---------||XXX---X-X|---BXXX|X-
----------------------------------------------|-----X----------------|---X----------X-X----|-----XX---|------------X-B----------|---------------o--------|-X-XXX---------B--------||XXXT--XXX|?------|X-
----------------------------------------------|-----XX-------------M-|--XX---------XXXX----|-----XXX--|-----------XX------------|------------------------|XXXXXX-X-----------T--T-||XXX|--XXX|X-----X|Xv
----------X----------------------------o------|-----XXX--------------|-XXX------?-XXXXX----|T----XXXX-|----------XXX------------|----------------BBBBBBB-|XXXXXXXXX---?????XX|XX|X||XXX|--XXX|XXX--XX|Xf
----------XX----------------------------------|-----XXXX-------------|XXXX----X--XXXXXX----||----XXXXX|---------XXXX------------|----------------------BX|XXXXXXXXXX----??XX-|BB|X||XXX|--XXX|XXX-XXX|Xf
----------XXX----------------T----------------|-----XXXXX----XXXXX---|XXXX----XXXXXXXXX-B--||X--?XTXXX|X-------XXXXX------------|--------------X----T--XX|XXXXXXXXXXX--T-XXXX|?X|X||XXX|X-XTX|XXXXXXX|Xf
----------XXXX---------------|--T-------------|-----XXXXXX----------X|XXXX----XXXXXXXXX-XXX||XX-TX|XXX|XX-----XXXXXX------------|-------------------|-XXX|XXXXXXXXXXXX-|XXXXX|XX|X||XTX|XXX|X|XXXXXXX|Xf
----------XXXXX--------------|BB|BBB----------|--X-?XXXXXXX---X----XX|XXXX-BB-XXXXXTXXX--XX||XXX|X|XXX|XXX---XXXXXXX------------|-------------------|XXXX|XXXXXXXXXXXXX|XXXXX|XX|X||X|X|XXX|X|XXXXXXX|Tf
----------XXXXXX-------------|-T|o---------M--|XXXX-XXXXXXXX-XX---XXX|XXXX---XXXXTX|XXX-XXX||XXX|X|XXX|XXXX-XXXXXXXX------------|--T-----------T----|XTXX|XXXXXXXXXXXXT|XTXXX|XX|T||X|X|XXX|X|XXXXXXX||f
m---------XXXXXXX--E----EE---|-||E---------BE-|--XXXXXXXXXXXXXX--XXXX|XXXX-EXXXXX|X|XXXXXXX||XXX|X|XXX|XXXXXXXXXXXXX----------E-|--|---E---E???|?oEX|X|XX|XXXXXXXXXXXX||X|XXX|XX||||X|X|XXX|X|XXXXXXX||X
XXXXXXXXXXXXXXXXXX--XBBXXXXXX|X||XXXXXXMXXXXXX|XXXXXXXXXXXXXXXX-XXXXX|XXXX-XXXXXX|X|XXXXXXX||XXX|X|XXX|XXXXXXXXXXXXXXXXXXXXXXXXX|XX|XXX-XXXoXX-|--XX|X|XX|XXXXXXXXXXXX||X|XXX|XX||||X|X|XXX|X|XXXXXXX||X
