-----------o---------------o----XXX------X--X-------Bo---M--------B---------------------------BBBBBBB-o---XB------X--------------B-------------XX-------------------------------------------------????--
---?------o--????------B----------------o---M-???----BoBBBBB-X------------------------M-----------------------?-----------BBBBBB-----------------------------?------------------B------BBB--------------
---------o--------------BBB--????????---------B--BX---M-----------------------------------------------?----------o---BBBBBBB---Bo------------------------?----------------------------------------------
-----------BBBBB-------------B---M-o-o------??????-B-------?BBBBBBBBB--o-----------o-----------?-----B------X--o----o-----------------------------------------------------------------------------------
-----???M?XXMXXXXX------X---------?o--?-------?----B--?----------X--------?----------o-B---M----------o----X----M?------------------BBB--------------------------X----BBBBBBB---------------------------
--------X--------------XX-XBBBBBBBBBBB------o---XBB?-X--M------XXX---X-----------------XXXXXXX-------MXX-----------oM-X-----M-----------------------------------XX--------------------------------------
---o?o??XXX?----X-----XXX-M---------X-----X-o---XXXXXXXX-----MXXXXBBBXXB???B---------------------?---XX----oB--Xo-----XX--o--B---------------------o-----?-----XXXX-------------M-------BBBBB-----------
------o-XXXX---XX----XXXX-----?o----XX----XX---XXXX--XXX-----XXXXXX--XXX--X-----?-----X---??????----XXXX-------XX---M-XXX-------------------------------------XXXX----------------------BBB------------v
--------XXXXX-XXX---XXXXX------XXX--XXX-M-XXXBXXXXXXXXXXX--BXXXXXXX--XXXX-XX---------XX------------XXXXXX------XXX----XXXX-----------------?-?---------------XXXXX----------o-------------X------------f
--------XXXXXXXXX--XXXXXXBBBB--XXX--XXXX--XXXXXXXXXXXXXXXX?XXXXXXXX?-XXXXXXXXBBBBo--XXX--?X-------XXXXXXXX-----XXXX?--XXXXX---------------------------------XXXXXX---------XX------??????-XX-----------f
--M-B---XXXXXXXXX-XXXXXXX------o-?--XXXXXXXXXXXXXXXXXXXXXXXXXXXXXXX-XXXXXXXXXX---X-XXXX-M-----o--XXXXXXXXXX----XXXXX--XXXXXX-------------------------------XXXXXXX--------XX--------------XXX----------f
-------XXXXXXXXXXXXXXXXXXXXXXXXX--o-XXXXXXXXXXXXXXXXXXXXXXXXXXXXXXX-XXXXXXXXXXX?XXXXXXX---------XXXXXXXXXXXX---XXXXXXXXXXXXXX-----------X--X--------?-----XXXXXXXX-------XXX--------------XXXX-------??f
---T-T-TXTXTTXXXXXXXXXXXTTTT-T-TT-T-TTXTXTXXTXXTXXXTTTXXTTTXXXTTXXX-XTXXXTTXXTXXTXXXTXT----TXT-TXTXXTXXXTXXXTT-XXXXXTTXXXXTXXX-T----T-----XXT---T-----TX-TXXXXXXXX-o----XTXTT----T-T------TXXXX--T---XXf
---|-|X|X|X||XXXXXXXXXXX||||?|?||X|-||X|X|XX|XX|XXX|||XX|||XXX||XXXXX|XXX||XX|XX|XXX|X|-?--|X|X|X|XX|XXX|XXX||-XXXXX||XXXX|XXXX|X---|---XXXX|---|-----|XX|XXXXXXXX-----XX|X||----|-|-o----|XXXXX-|-----f
m-E|X|X|X|X||XXXXXXXXXXX||||-|E||X|-||X|X|XX|XX|XXX|||XX|||XXX||XXXXX|XXX||XX|XX|XXX|X|-E--|X|X|X|XX|XXX|XXX||XXXXXX||XXXX|XXXX|XX--|E--XXXX|--E|----X|XX|XXXXXXXX-E--XXX|X||EE--|-|------|XXXXXX|-----X
XXX|X|X|X|X||XXXXXXXXXXX||||X|X||X|X||X|X|XX|XX|XXX|||XX|||XXX||XXXXX|XXX||XX|XX|XXX|X|---X|X|X|X|XX|XXX|XXX||XXXXXX||XXXX|XXXX|XXX-|--XXXXX|XXX|XXXXX|XX|XXXXXXXX---XXXX|X||X---|-|--XXXX|XXXXXX|-XXXXX
