--------------------------------------------------------------------------XXXXXXX--X----M--????????-----B---------o-------M-X------------------------------------??----------X--------------------------
--------------------------------------------------------------------o-------------------------?---------o----------?-B---------o----------------------------X-o----------XB-o---------------------X-----
--------------------------------------------------------o-----------o-----M--------------?-----------------------------------M--------------------------------------------------------X-?-------------B-
-----------------------------------------------------------------------o----------------------o-------o-------T--------------------MX----------------------------------------T-XXXXXX---BBBBBBBB--------
-------------T---------------------------------T---------------------------T------------------------T------X--|---------X-----------------------X------------------XXXXXXXX--|---XXXBoXo--XTXXX---X-o---
-----o-------|---------------------------------|---------------------------|-------------------TXBT-|-----XX--|-----???XX???-B--------M--------XX-----------T------------XX--|--T-------BXX|XX-?-XX--XT-
-------------|---------------------------------|---------------------------|-------------------|XX|o|----XXX--|-------XXX-M-B-T---------------XXX---------??|??---------XXX--|--|X------XXX|XX--XXXoXX|-
-X-----------|---------------------------------|---------------------X-----|-o--------------BTB|XX|B|---XXXX--|------XTXX----o|M---T-X-------XXXX-----------|----------XXXX--|--|X--T?-XXXX|XXBXXXXXXX|v
---X---------|---------------------------------|------?---X---------XX-----|------T--B------X|-|XX|X|--XXXXX--|-T---XX|XX-----|----|XX------XXXXX-----------|--X---o--XXXXX--|--|XX-|-XXXXX|XXXXTXXXXX|f
---XX--------|---------------------------------|----------XX-------XXX-----|?T????|--To----XX|-|TX|X|BXXXXXX--|-|XXXXX|XX----X|-X--|XX-----XXXXXX-----------|-oXXT???XXXXXX-T|--|XXX|XXXTXX|XXXX|XXXXT|f
---XXX-------|---------------------------------|----------XXX-----XXXX-----|-|--?-|--|-?T-XXX|-||X|X|TXXXXXX--|-|-XXXX|XXT----|XXXX|XX----XXXXXXX----------B|BBXX|BBXXXXXXXX||--|XXX|XXX|XX|XXXX|XXXX||f
---XXXX------|---------------------------------|----------XXXX---XXXXX-----|-|--o-|--|-T|XXXX|-||X|X||XXXXTX--|-|XXXXX|XX|XT--|XXXX|XX---XXXXXXXX-------M---|--XX|XXXXXXXXXX||-M|XXX|XXX|XX|XXXX|XXXX||f
---XXXXX-----|---------------------------------|---------MXXXXX-XXXXXX----X|-|----|X-|-||XXXX|-||X|X||XXXX|XX-|-|XXXXX|XX|X|--|XXXX|XX--XXXXXXXXX-----------|--XX|XXXXXXXXXX||--|XXX|XXX|XX|XXXX|XXXX||f
---XXXXXX----|---------------------------------|----------XXXXXXXXXXXX----X|-|----|XX|-||XXXX|-||X|X||XXXX|XXX|X|XXXXX|XX|X|X-|XXTX|XXBXXXXXXXXXX-----------|--XX|XXXXXTXTXX||X-|XXX|XXX|XX|XXXX|XXXX||f
mE-XXXXXXX---|---------------------------------|----------XXXXXXXXXXXX----X|X|E--E|XX|X||XXXX|E||X|X||XXXX|XXX|X|XXXXX|XX|X|XX|XX|X|XXXXXXXXXXXXX-----------|--XX|XXXXX|X|XX||XX|XXX|XXX|XX|XXXX|XXXX||X
XXXXXXXXXXXXX|XXXXXXXXXXXXXXXXXXXXXXXXXXXXXXXXX|XXXXXXXXXXXXXXXXXXXXXXXXXXX|X|----|XX|X||XXXX|-||X|X||XXXX|XXX|X|XXXXX|XX|X|XX|XX|X|XXXXXXXXXXXXXXXX-------X|--XX|XXXXX|X|XX||XX|XXX|XXX|XX|XXXX|XXXX||X
