-------------------------M------------------------------------BBBBBBBXXXXXBBBBBBB--------B-------------M-oo-------------o-----oo--B-----------------------------------------------------------o---------
----------------------------------o---------------------------------X---------M-X---------------------BX---------------o--------------M---??????-o--M---?-----------------------------------------------
--------------------------------------------------------M-------------------X-----?----?------------X---o----X---------BBBBB-?------BBBBB---------BBX------------o-----------------X-----------XXXXXX---
----------o---------------------------------------------------------o---------------X------T----------T-------------------------------------M-T------------------------------------T---------T-----o-T--
--------------------------------o------------------------------oM--------------------?-----|-o--------|----o------???---M-X-X-----o-T---------|-----------------------------------T|---------|------X|--
----------------------------------------------T----------------------T--BBBB--------------T|-----XT---|------------X---T-XXXX-------|--TTTT--X|X---?????-T------------M-----------||--o-----X|-------|X-
----------------------------------------------|-----X----------------|---X------------X---||-----X|---|-----BXBBBMXX-T-|XXXXX-o---X-|-B||||-XX|X?--------|------------------------||---T----X|-------|X-
----------------------------------------------|-----XX-------------M-|--XX-----------XX-BB||B----X|X--|------XX--XXX-|-|XXXXX----TXX|--||||XXX|X---M---T-|-------X----------------||---|----X|X------|Xv
----------X----------------------------o------|-----XXX--------------|-XXX------?---XXX---||T----X|XX-|-----TXXXXXXXT|X|XXXXT--T-|XX|--||||XXX|X-BBBBBB|-|------XXX------?-X------||---|----X|XX-----|Xf
----------XX----------------------------------|-----XXXX-------------|XXXX----X----XXXX-X-|||----X|XXX|T-M--|XXXXXXX||X|XXXX|-X|-|XX|Xo||||XXX|X-------|-|---BBXXXXX------XX------||---|----X|XXX----|Xf
----------XXX----------------T-------X--------|-----XXXXX----XXXXXX--|XXXX----XX--XXXXX-B-|||Xo-?X|XXX||----|XXXXXXX||X|XXXX|XB|-|XX|XX||||XXX|X-------|-|----XXXXXXX--T-XXX------||---|---TX|XXXX---|Xf
----------XXXX---------------|--T----XX-------|-----XXXXXX----------X|XXXX----XXXXXXXXX-XX|||XX-TX|XXX||X--X|XXTXXXX||X|XXTT|XX|X|XX|XX||||XXX|XBB----?|-|---XXXXXXXXX-|XXXX------||---|---|X|XXXXX-B|Xf
----------XXXXX--------------|BB|BBB-XXX------|--X-?XXXXXXX---X----XX|XXXX-BB-XXXXXTXXX--X|||XXX|X|XXX||XXXX|XX|XXTT||X|XT|||XX|T|XX|XX||||XXX|X---X---|-|--XXXXXXXXXXX|XXXX??????||---|---|X|XXXXXX-|Tf
----------XXXXXX-------------|-T|o---XXXX--M--|XXXX-XXXXXXXX-XX---XXX|XXXX----XXXTX|XXX-XX|||XXX|X|XXX||XXXX|XX|XX||||X|X||||XX|||XT|XX||||XXX|T--XX--T|-|-XXXXXXXXXXXX|XXXX------||---|--o|X|XXXXXXX||f
m---------XXXXXXX--E----EE---|-||E---XXXXX-BE-|--XXXXXXXXXXXXXX--XXXX|XXXX-E--XXX|X|XXXXXX|||XXX|X|XXX||XXXX|XX|XX||||X|X||||XX|||X||XX||||XXX||-XXX--||X|XXXXXXXXXXXXX|XXXX------||--E|---|X|XXXXXXX||X
XXXXXXXXXXXXXXXXXX--XBBXXXXXX|X||XXXXXXXXXXXXX|XXXXXXXXXXXXXXXX-XXXXX|XXXXX-XXXXX|X|XXXXXX|||XXX|X|XXX||XXXX|XX|XX||||X|X||||XX|||X||XX||||XXX||XXXXXX||X|XXXXXXXXXXXXX|XXXX-----X||XXX|-XX|X|XXXXXXX||X
