---------------------------------------------------------------------------------------------o-------------------------------------------------------------------------------X-----------------?-oo-----
-----------------------------------------------------------------------------------o---------------------------o------MX----------------------------------------------------------------------------?---
--------------------------------------------------------------------------------------------------------------M------------------------------------------------------------BBBBB---------o-------BBBXXX-
-----------------------------------------------------------------------------------------------------------M------------------------------------------------------------------------------XXXXXXX----o--
-------------------------------------------------------------------------------------------------------o----------------------o----------------------------------------------------------------o?----X--
--------------------------------------------------------------------------------------------------------------------------?---o-------o----------------------------------------------------------o-XXX--
-------------------------------------------------------------------------M---------------------------------X------------------------------------------------------------------------XXXXXXXX------XXXXX-
----------------------------------------------------------------------------------------------X----------o-X----------------------X--------------------------------------------------------------XXXXXXv
---------------------------------------------------------------------------------------------XX--X----BMBBXX-------------X-------XX-------------------------------------------------------B--XX-XXXXXXXf
---X--------------------------------------------------------------M-------------------------XXX-XX-------XXX-------------XX-----XXX-----------------------------------------------------------XXXXXXXXXf
---XX----------------------------------------------------------------M---------------------XXXXXXX------XXXX?------------XXX---XXXX-----------------------------------------------------------XXXXXXXXXf
---XXX------------------------------------------------------------------------------------XXXXXXXX-----XXXXX-------------XXXX-XXXXX----------------------------------------------------------XXXXXXXXXXf
---XXXX----------------------------------------------------------------TT--------TT----T-XXXXXXTXXT---XXXXXX?-------T----XXXXXXXXXX----------------------------------------------T----T-----XXXXXXTXTXXf
---XXXXX---------------------------------------------------------------||--------||-XXX|XXXXXXX|XX|--XXXXXXXX-------|---oXXXXXXXXXX----------------------------------------------|----|----XXXXXXX|X|XXf
m--XXXXXX---------------------------------------------------E-E--------||--------||----|XXXXXXX|XX|XXXXXXXXXXX------|----XXXXXXXXXX--X------------------------------------------E|---E|--BXXXXXXXX|X|XXX
XXXXXXXXXXXXXXXXXXXXXXXXXXXXXXXXXXXXXXXXXXXXXXXXXXXXXXXXXXXXXXXXXXXXXXX||XXXXXXXX||XXXX|XXXXXXX|XX|XXXXXXXXXXXX--o-X|XXXXXXXXXXXXXXXXXXXXXXXXXXXXXXXXXXXXXXXXXXXXXXXXXXXXXXXX----|XXXX|o-XXXXXXXXX|X|XXX
