----XXXXXXXX----------------------------------------------------------------------------------------------------------------------M----------------------------------------------------------M----------
--------------------------------------------------------------------------------------------------------------------------------------------------------------------------------------------------------
--------------------------------------------------------------------------------------------------------------------------------------------------------------------------------------------------------
--------------------------------------------------------------------------------------------------------------------------------------------------------------------------------------------------------
---------------------------------------------------------------------------------------------------------?---------------------------------------------------------------------o------------------------
---------------------------------------------------------M---------------------------------------------------------o---------?---------------------------------------------------------------------????-
------------------------------------------------------------------------------------------------BBB--------XXX------------------------------------------------------------------------------------------
-------------------------------------------------------------------------------------------------------------------------------------------------------------------------------------------------------v
--B-----------------------------------------------X---------X------------------------------------------------------------------------???????-----X--------------------------------------B-------------Xf
--------------------------------------------------XX-------XX------------------------------------------------------------------------------------------------------------------------------------------f
-----------X--------------------------------------XXX-----XXX------------------------------------------------------------------------------------------------------------------------------------------f
-----------XX-------------------------------------XXXX---XXXX----------------------------------------------------?---------------------------------------M---------------------------------------------f
-----------XXX--------------------------------B---XXXXX-XXXXX-------------------------------TT--T--------------------------T----------?--------------T-------------------?-----------------------------f
-----------XXXX-----------------------------------XXXXXXXXXXX-----------????????------------||--|-----------------M--------|-------------------------|-------------------------------------------------f
m--------EEXXXXX---------E------------------E-----XXXXXXXXXXX-E-----------E--------E???-----||--|----E---------E-----------|-------------------------|------E------------------------E-----------------X
XXXXXX----XXXXXXX----XXXXXXXXXXXXXXXXXXXXXXXXXXXXXXXXXXXXXXXXXXXXXXXXXXXX---o--XXXXXXXXXXXXX||--|--XXXXXXXXXXXXXXXXXXXXXXXX|XXXXXXXXXXXXXXXXXXXXXXXXX|XXXXXXXXXXXXXXXXXX-----XXXXXXXX-XXXXXXXXXXXXXXXXXX
