--------------------------------------------------------------------------------------------------------------------------------------------------------------------------------------------------------
--------------------------------------------------------------------------------------------------------------------------------------------------------------------------------------------------------
--------------------------------------------------------------------------------------------------------------------------------------------------------------X-----------------------------------------
----------------------------------------------------------------X---------------------------------------------------------------------------------------------------------------------------------------
------------------------------------------------------------------------------------------------------------------------------------------------------?????--------------------o------------------------
-------------------------------------------------------------?-------------------------------------------------------------------------------------------------------------------------------------????-
---X--------------------------------------------------------------X------------------------------------------------------------------------------------------X------------------------------------------
--MXX------------------------------------------------------------XX---------------------------------------------------------------------------------B-------XX-----------------------------------------v
---XXX----------------------------------------------------------XXX-------XXXX-----------------------------------------------------------------------------XXX----------------------------------------Xf
---XXXX--------------------------------------------------------XXXX---------------------------------------------------------------------------------------XXXX-----------------------------------------f
---XXXXX------------------------------------------------------XXXXX--------------------------------------------------------------------------------------XXXXX-----------------------------------------f
---XXXXXX----------------------------------------------------XXXXXX-------------------------------------------------------------------------------------XXXXXX--------------------------------X--------f
---XXXXXXX------------------------------?-------------------XXXXXXX-----T------------------------------------------------------------------------------XXXXXXX-----------?--------------------------T--f
---XXXXXXXX------------------------------------------------XXXXXXXX-----|-----------------------------------------------------------------------------XXXXXXXX--------------------------------------|--f
m--XXXXXXXXX----------------------------------------------XXXXXXXXX-----|--------M-------------------------------------------------------------------XXXXXXXXX-----------------------E--------------|--X
XXXXXXXXXXXXXXXXXXXXXXXXXXXXXXXXXXXXXXXXXXXXXXXXXXXXXXXXXXXXXXXXXXXXXXXX|XXXXXXXXXXXXXXXXXXXXXXXXXXXXXXXXXXXXXXXXXXXXXXXXXXXXXXXXXXXXXXXXXXXXXXXXXXXXXXXXXXXXXXXXXXXXXXX-----XXXXXXXXBBXXXXXXXXXXXXX|XXX
