------------------------------------------------------------------------------------------------------M--------------------------------o----------------------------------------------------------------
------------------------------------------------------------------------------------------------------------------------------------------------------------------------------------------------BBBBBBB-
-----------------------------------------------------------------------------------o--------------------------------?------------------------?????------------------------------------------------------
--------------------------------------------------------------------------------------------------------------------Bo-------?----X------XXXX-----------------------------------------------o-----------
-----------------------------------------------------------------------------------------------------------------------X-------------------------------------------------------------????------------B--
-------o--------------------------------------------------------------------------------------------------------------XX--------------------X-------X----------------------------------------------M----
---------------------------------------------------------------------------------------------------------X-------X---XXX----------------X--XX------XX------------------------------------------------XX-
--------------------------------------------------------------------------------------------------------X----X------XXXX---------------XX-XXX-----XXX-----------------------------------------------XXXv
-------------------------------------------------------------------------------------------------------XX---XX--B--XXXXX--X-----------XXXXXXXB---XXXX----------------------------------------------XXXXf
------------------------------------------------X--------------------------------------XX-------------XXX--XXX----XXXXXX-XX----X----XXXXXXXXX---XXXXX---------------------------------------------XXXXXf
-----------------------------------------------XX-----------------------X----------------------------XXXX-XXXX---XXXXXXXXXX---XX----XXXXXXXXXB-XXXXXX--------------------------------------------XXXXXXf
----------------------------------------------XXX-------?-------------------------------------------XXXXXXXXXX--XXXXXXXXXXX--XXX---XXXXXXXXXXMXXXXXXX-------------------------------------------XXXXXXXf
---------------------------------------------XXXX---------------------------------T-----------T--TTXTXXXTXTXXXTXXTXXXXTXXXX-TXXT--XXXXXXXXXXXXTXXXXXX------------------------------T---------M-TXXTXTXXf
--------------------------------------------XXXXX---------------------------------|---------?-|--||X|XXX|X|XXX|XX|XXXX|XXXXX|XX|-XXXXXXXXXXXXX|XXXXXX------------------------------|----------X|XX|X|XXf
m------------------------------------------XXXXXX-------------------------------E-|-E---------|--||X|XXX|X|XXX|XX|XXXX|XXXXX|XX|XXXXXXXXXXXXXX|XXXXXX------------------------------|---------XX|XX|X|XXX
XXXX----------XXXXXXXXXXXXXXXXXXXXXXXXXXXXXXXXXXXXXXXXXX-----XXXXXXXXXXXXXXXXXXXXX|XXXXXXXXXXX|-X||X|XXX|X|XXX|XX|XXXX|XXXXX|XX|XXXXXXXXXXXXXX|XXXXXXXXXXXXXXXXXXXXXXXXXXXXXXXXXXXX|XXXXXX--XXX|XX|X|XXX
