---------------------------------------------------------------------------------------------?--??????-----------o--------------------------------------------------------------------------------------
-------------------------------------------------------------------------------------------------------------------------------B-----------------------------------------------------------????????-----
-------------------------------------------------------------------------------------------------------------------------------------------------------------------------------------X-----XXXXXXXX-----
------------------------------------------------------------------------------------------?-------------X---------------------------------------------------------------------BBBBBB--------------------
--------------------------------------------------------------------------------------------------------------------?-----------------------------------------------------------------X?----------------
------------------------------------------------------M---------------o----------X-XXXX-----X----------B-------------X---------------------------------------------------------------XX------------?----
------------------------------------X-----------------------------------M------------X-----XX--?-------------o------XX--------------------------------------------------------------XXX--XXXXXXXX-------
-----X---------------------------------------------------o---X-----X-----------------XX---XXX----X-----------------XXX--------------------------------------------------XX---------XXXX-X--------------v
-----XX---------------------------------------------?--------XX---XX------------M----XXX-XXXX----XX?--X-B-oo------XXXX------------------------------------------------------------XXXXX-XX---------X---f
-----XXX-----------------------------------------------------XXX-XXX-----------------XXXXXXXX????XXX--XX---------XXXXX-----------------------------------------------------------XXXXXX-XXX----X?BXXB??f
-----XXXX--------------------------------------------X-------XXXXXXXX----X-----------XXXXXXXX----XXXX?XXX-------XXXXXX--------------------------------------------X-------------XXXXXXX-XXXX--XXXXXX---f
-----XXXXX-------------?---------------------XXXXXXXXX-------XXXXXXXX----------------XXXXXXXX----XXXXXXXXX-----XXXXXXX----X---------------------------------------XX-----------XXXXXXXXoXXXXXXXXXXXX---f
-----XXXXXX------------------------------T---------XXXBBBTT--XXXXXXXX-TT-----TT------XTXXXTXX--TTXXXXXXXXXT-TTXXXTXTXX---XX---------------------------------------XXX---------XXXXXXXXT-XXXXTTXXXXXX-X-f
-----XXXXXXX-----------------------------|--------XXXX---||--XXXXXXXX-||-----||-----XX|XXX|XX--||XXXXXXXXX|X||XXX|X|XX--XXX---------------------------------------XXXX-------XXXXXXXXX|-XXXX||XXXXXXo--f
m----XXXXXXXX----------------------------|-E-----XXXXX---||-XXXXXXXXX-||---EX||----XXX|XXX|XXX-||XXXXXXXXX|X||XXX|X|XX?XXXX---------------------------------------XXXXX-----XXXXXXXXXX|-XXXX||XXXXXXX--X
XXXXXXXXXXXXXXXXXXXXXXXXXXXXXXXXXXXXXXXXX|XXXXXXXXXXXXXXX||XXXXXXXXXXX||-XXXX||XXXXXXX|XXX|XXXX||XXXXXXXXX|X||XXX|X|XXXXXXXXXXXXXXXXXXXXXXXXXXXXXXXXXXXXXXXXXXXXXXXXXXXXXXXXXXXXXXXXXX|XXXXX||XXXXXXXXXX
