--------------------------------------------------------------------------------------------------------------------------------------------------------------------------------------------------------
--------------------------------------------------------------------------------------------------------------------------------------------------------------------------------------------------------
-------------------------------------------------------------------------------------------------------------------------------------------------------------------------------E----To------------------
---------------------------------------------E------------------------o-------------------X----------------------------------------------------------------------------T--------------------------------
------------------------------X----------o--X----------------------------------------------------------------------------------X-------------------|----------------------------------------------------
---------------------------------------------------------------------------------------------------------------------------------|----------------------------------------------------------------------
----------------------------------------------------------------------------------------------------------------------X--------------------X----------------------------T-------------------------------
--------------------------------------------------------------------------T-----------------------------------------------------------------------------------E----------------------------------------v
-------------------------------------T----T----------------------T----------------------------------------------------------------------------------------X----------------o---------------------------f
---T------------------------------------------------------------------------------------o---------------------------T------------------------------------------|---------------------------------------f
--E----X------------------------------------------------------------------------------------------T-------------------T--------------------------------------------------------------------------------f
-------------------------------------X----------------------------------------------------------------------X-------------------------------------X----------------------------------------------------f
-------------X--------------------------------E------------------------------------------------------------E-----------------------E-------------------X---------------------------o-------------------f
---------------------------------------X-----------------------------------o------------------------------------------------------------------------------------------------o-----o--------------------f
m------------------------------------------------------------------------------------------------------------------------------------------------------------------------------------------------------X
XXXXXXXXXXXXXXXXXXXXXXXXXXXXXXXXXXXXXXXXXXXXXXXXXXXXXXXXXXXXXXXXXXXXXXXXXXXXXXXXXXXXXXXXXXXXXXXXXXXXXXXXXXXXXXXXXXXXXXXXXXXXXXXXXXXXXXXXXXXXXXXXXXXXXXXXXXXXXXXXXXXXXXXXXXXXXXXXXXXXXXXXXXXXXXXXXXXXXXXX
