-------------------------------------------------------------------------------------XXXX--------------------------------------B-?-MBBBBBB?BB-XXXXXXB---------------------------------------------------
---------------------------------------------------------------------------------------------------------------B-------M-------B------B--------????????-------o----------------oBBBB-----------o--------
-----------------------------------------------------------------------------------o--o----------------------?o?-----------?--------M------------------------------XXXXXXXXXX-----------------?---------
--------M--------------------------------------------------------------------------------------------T--------XX-T---------X-----M-BBBBBB----------BBBBBB----------X-------------------------T-------X--
-----------------------------------------------------------------------------------------------------|M---T-BBX--|---------------X-?-TX-X---T--T-X--o---------------------------------------X|-------X--
-----T---------------------------------------------------------------X-----------o-------------T-----|----|--XX--|-BB-----XXXXXXXXT--|T--X--|-X|TXX?----------X----------------------------XX|T-----XXX-
-----|---------------------------------------------------o-----------XX----X-------------------|--X--|-To-|?XXX--|-----XX-XXXX-XXX|XX||XXX--|TX||XX-X--------XX---------------------------XTX||--XoXXXX-
-----|X-------X------------------------------------------X-----X-----XXX---XX------XB------X---|B---o|-|--|XXXXT-|---oXXX-XXXXXXXX|-X||XXX--||T||XX-XX---T--XXX---------T----------------XX|X||X-XXXXXXv
-----|--------XX-----------------------------------------------XX----XXXX--XXX----TXX-----XX--X|X----|B|--|XXXX|B|o-TXXXXoXXXXXXTX|XX||XXXX-|||||TXXXXX--|-XXXX---------|---------------XXX|X||XXXXXXXXf
-----|--------XXX----------------------------------------------XXX---XXXXX-XXXX---|XXX---XXX-XX|XXT--|-|-X|XXXX|-|--|XXXX-XXXXXX|X|XX||XXXXX||||||XXXXXX-|XXXXX---------|--------------XXXX|X||XXXXXXXXf
-----|--------XXXX------o--------------------------------------XXXX--XXXXXXXXXXX--|XXXX-XXXXXXX|XX|T-|-|XX|XXXX|X|-X|XXTXTXTXXXX|X|XX||XXXXX||||||XXXXXXX|XXXXX---------|----------T--XXXXX|X||XXXXXXXXf
-----|--------XXXXX--------------------------------------------XXXXX-XXXXXXXXXXXX-|XXXXXXXXXXXX|XX||-|T|XX|XXXX|X|XX|XX|X|X|XTXX|X|XX||XXXXX||||||XXXXXXX|XXXXX---------|-BBB------|-XXXXXX|X||XXXXXXXXf
-----|--------XXXXXX-------------------------------------------XXXXXXXXXXXXXXXXXXX|TXXXXXXXXXXX|XX||X|||XX|XXXX|X|XX|XX|X|X|T|XX|X|XX||XXXXX||||||XXXXXXX|XXXXX---------|-----BBBBB|XXXXXTX|X||XXXXXXXXf
-----|--------XXXXXXX------------------------------------------XXXXXXXXXXTXXXXXXXX||XXXXXXXXXXX|XX||X|||XX|XXXX|X|XX|XX|X|X|||XX|X|XX||XXTXX||||||XXXXXXX|XXXXX---------|----------|XXXXX|X|X||XXXXXXXXf
m----|--------XXXXXXXX-----------------------------------------XXXXXXXXXX|XXXXXXXX||XXXXXXXXXXX|XX||X|||XX|XXXX|X|XX|XX|X|X|||XX|X|XX||XX|XX||||||XXXXXXX|XXXXX-----E---|--------EX|XXXXX|X|X||XXXXXXXXX
XXXXX|XXXXXXXXXXXXXXXXXXXXXXXXXXXXXXXXXXXXXXXXXXXXXX-XXXXXX---XXXXXXXXXXX|XXXXXXXX||XXXXXXXXXXX|XX||X|||XX|XXXX|X|XX|XX|X|X|||XX|X|XX||XX|XX||||||XXXXXXX|XXXXXXXXXXXXXX|XXXXXXXXXX|XXXXX|X|X||XXXXXXXXX
