------M-----------o-------------------------------B-------------------------------------------------?---------------------------------------------------------------------------------------------------
------------------------------------------------------o-------------------o-------o---------------------------------------------------------------------------------------------------------------------
-----------XBBBBXX----?-------------------B----------B------o----------------------M------M------------------o-----------------------------------------------------------------M---o--------------------
-------------------XX---------------------------o----------------------------------------M--------------------------------------------------------------------------------------------------------------
----------------B----X--------------------MBBBX-----XXXXXXXXXXXX--------------------------------------------------------------------------------------------------------o-------------------------------
---XBoB-X-?---------XX------------------------------o-----XX--XXXXXo-M---------o-o----------------------------------------------------------------------------------------------------------------------
---XX?--XXX----XB-BXXXBBB-------------X-------MM---------XXX-XXX---Xo----MX--------------------------------------X--------------------------------------------------------------------------------------
---XXX--XXXX--XXBBXXXXBB--------------XX?????----X-XX--XXXXXXXXX---XX---X-XX--?----------------------------------XX-M----------?-----------------------------------------------------------------------v
---XXXX?XXXXXXXX-XXXXX----------------XXX-------------XXXXXXXXXX---XXX-XX-XXX?XXXXXXXX-?--------X----------------XXX------X----------------------------------------------------------------------------f
---XXXXXXXXXXXXXXXXXXX----------------XXXX-----------XXXXXXXXXXXBB-XXXXXX-XXXX-XBBBBBB---X-----XX------XXXXX-----XXXX-----XX---------------------------------------------------------------------------f
---XXXXXXXXXXXXXXXXXXX---X------------XXXXX---------XXXXXXXXXXXX---XXXXXX-XXXXXXX--------XX---XXX----------------XXXXX----XXX----------BBBB---------X--------------------------------------------------f
---XXXXXXXXXXXXXXXXXXX---XX-----------XXXXXX-?-----XXXXXXXXXXXXXX--XXXXXX-XXXXXXXX-----B-XXX-XXXX----------------XXXXXX---XXXX---------------B-----XX--------------------------------------------------f
---XTXXXXXXTXTXTXXXXXT---XXX----------XXXXXTX-----TXTXXXXXTXXTTXXX-XXTXXXXXXXXTTXXX-T-T--XTXXXXXX-----T------T---XXXXXXX--XXXXX-------------------XXX--------------------------------T-----------------f
---X|XXXXXX|X|X|XXXXX|-XXXXXX---------XXXXX|XXo--X|X|XXXXX|XX||XXXXXX|XXXXXXXX||XXXX|-|--X|XXXXXX-----|----o-|---XXXXXXXX-XXXXXX-----------------XXXX--------------------------------|------M----------f
m--X|XXXXXX|X|X|XXXXX|BB-XXXXX--------XXXXX|XXXEXX|X|XXXXX|XX||XXXXXX|XXXXXXXX||XXXX|E|X-X|XXXXXX-----|------|-E-XXXXXXXXXXXXXXXXE--------------XXXXX--------------------------------|----------E------X
XXXX|XXXXXX|X|X|XXXXX|---XXXXXXXXXXXXXXXXXX|XXXXXX|X|XXXXX|XX||XXXXXX|XXXXXXXX||XXXX|X|XXX|XXXXXX-----|------|--XXXXXXXXXXXXXXXXXXXXXXXXXXXXXXXXXXXXXXXXXXXXXXXXXXXXXXXXXXXXXXXXXXXXX|XXXXXXBXXXXXXXXXXX
