--------------------------------------------------------------------------------------------------------------------------------------------------------------------------------------------------------
--------------------------------------------------------------------------------------------------------------------------------------------------------------------------------------------------------
--------------------------------------------------------------------------------------------------------------------------------------------------------------------------------------------------------
--------------------------------------------------------------------------------------------------------------------------------------------------------------------------------------------------------
--------------------------------------------------------------------------------------------------------------------------------------------------------------------------------------------------------
--------------------------------------------------------------------------------------------------------M------------------------------------------------------------------------------------------????-
--------------------------------------------------------------------------------------------------------------------------------------------------------------------------------------------------------
-----------------------------------------------------------------------------------------------------------------------------?----------------------B-----------------------------------o--------------v
------------X-------------------------------------------------------------------------------------------X-------------------------------------------------------------------------------B--------------f
------------XX-----------------------------------------------------------------------------------------XX----------------------------------------------------------------------------------------------f
------------XXX---------------------------------------------------------------------------------------XXX----------------------------------------------------------------------------------------------f
------------XXXX--------------------------------------------------?----------------------------------XXXX---o------------------------------------------------------------------------------------------f
--T---------XXXXX---------------------------------------------------------------------------T-------XXXTX----?----------------------------------T------------------------------------------------------f
--|--?------XXXXXX------------------------------------------------------????????------------|------XXXX|X---------------------------------------|------------------------------------------------------f
m-|---------XXXXXXX----------------------------------------------E--E-E---E---E----???o-----|E----XXXXX|X-----------E----E----------------------|------------------------------------------------------X
XX|XXXXXXXXXXXXXXXXXXXXXXXXXXXXXXXXXXXXXXXXXXXXXXXXXXXXXXXXXXXXXXXXXXXXXXXXXXXXXXXXXXXXXXXXX|---XXXXXXX|XXXXX---XXXXXXXX-------XXXXXXXXXXXXXXXXX|XXXXXXXXXXXXXXXXXXXXXXXXXXXXXXXXXXXXXXXXXXXXXXXXXXXXXXX
