---------------------------------------------------------------------?-------------------------------------------?----------------------------------------------------------------B---------------------
--------------------------------------------------------------------------------------------------------M---------------------------------------------------------------------------o----?--?--o--------
------------------------------------------------------------------------------------------------------------------o----------------------------------------------??????---------------???---------------
------------------------------------------------------------------------------------------------------------------------------------------------------------------------???????---------------------B---
-------------------------------------------------------------------------------------------------------------X?-------------------------------------------------------BBB-------BX-X-----?X----X------X-
---------------------------------------------------------o------------------------------------------o-X--B--XX------------------------------------------------------X--X--X-BBBBXXXXX-XX-XXX--XX-----XX-
-----------------------------------------------------------------------------------------------MX-----XX---XXX-----------------------------------------------------XX-XX-XXX---XXXXXXXXXXXXXXXXX?X--XXX-
-----------------------------------------------------------------------------------------------------BXXX-XXXX--------------------------------------------------XXXXXXXXXXXXX?XXXXXXXXXXXXXXXXXXXX-XXXXv
------------------------------------------------------------------------------------------------------XXXXXXXX----BBBBBBBB---------------------------------------XXXXXXXXXXXXXXXXXXXXXXXXXXXXXXXXXXXXXXf
-------------------------------------------------------------------X----------------------------X-----XXXXXXXX-X----------------------------------------------X-XXXXXXXXXXXXXXXXXXXXXXXXXXXXXXXXXXXXXXXf
------------------------------------------------------------------------X---------------X----B-----X--XXXXXXXXX-----------------------------------------------XXXXXXXXXXXXXXXXXXXXXXXXXXXXXXXXXXXXXXXXXf
--------X-----------------------------------------------------------------------XXXXXX--XX-------o-o--XXXXXXXXXX--------------------------------------------?-XXXXXXXXXXXXXXXXXXXXXXXXXXXXXXXXXXXXXXXXXf
------------------------------------------------------------------T------T------T----T--XXX--T------BXXXXXXXXXXTX--------------------------------------------XXXTTXXXTTTXXXXXXXTXXXXTXXXXTTXXXXXTTXXTXXf
------------------------------------------------------------------|------|------|----|--XXXX-|------XXXXXXXXXXX|XX------------------------------------------XXXX||XXX|||XXXXXXX|XXXX|XXXX||XXXXX||XX|XXf
m----o-E--------------------------------------X-------E-----------|--E---|??----|----|--XXXXX|-E---XXXXXXXXXXXX|XXXE---------------------------------------XXXXX||XXX|||XXXXXXX|XXXX|XXXX||XXXXX||XX|XXX
XXX--------XXXXXXXXXXXXXXXXXXXXXXXXXXXXXXXXXXXXXXXXXXXXXXX-X---XXX|-----X|XXXXXX|XXX-|--XXXXX|----XXXXXXXXXXXXX|XXXXXXXXXXXXXXXXXXXXXXXXXXXXXXXXXXXX------XXXXXX||XXX|||XXXXXXX|XXXX|XXXX||XXXXX||XX|XXX
