------M-----------o-------------------------------B-------------------------------------------------?---------------------------------------------------------------------------------------------------
------------------------------------------------------o-------------------o-------o---------------------------------------------------------------------------------------------------------------------
-----------XBBBBXX------------------------B----------B------o----------------------M------M------------------o-----------------------------------------------------------------M---o--------------------
------------------------------------------------o----------------------------------------M--------------------------------------------------------------------------------------------------------------
------------------------------------------MBBBX--X--XXXXXXXXXXXX--X-----------------------------------------------------------------------------------------------------o-------------------------------
---XBoB-X-?-------------------------------------XX--o-----XX--XXXXXo-M---------o-o----------------------------------------------------------------------------------------------------------------------
---XX?--XXX----XB---------------------X-------MXXX-------XXX-XXXXXXXo----MX--------------------------------------X--------------------------------------------------------------------------------------
---XXX--XXXX--XXBBBBBBBB--------------XX?????-XXXX-XX--XXXXXXXXXXXXXX---X-XX--?----------------------------------XX-M----------?-----------------------------------------------------------------------v
---XXXX?XXXXXXXX----------------------XXX----XXXXX----XXXXXXXXXXXXXXXX-XX-XXX?XXXXXXXXX?--------X----------------XXX------X----------------------------------------------------------------------------f
---XXXXXXXXXXXXX---B------------------XXXX--XXXXXX---XXXXXXXXXXXXXXXXXXXX-XXXX-XBBBBBXX--X-----XX------XXXXX-----XXXX-----XX---------------------------------------------------------------------------f
---XXXXXXXXXXXXX----------------------XXXXXXXXXXXX--XXXXXXXXXXXXXXXXXXXXX-XXXXXXX---XXX--XX---XXX----------------XXXXX----XXX----------BBBB---------X--------------------------------------------------f
---XXXXXXXXXXXXXX------o--------------XXXXXXXXXXXX-XXXXXXXXXXXXXXXXXXXXXX-XXXXXXXX-XXXXB-XXX-XXXX----------------XXXXXX---XXXX---------------B-----XX--------------------------------------------------f
---XTXXXXXXTXTXTXX--------------------TXXXXTXXXXXXTXTXXXXXTXXTTXXXXXXTXXXXXXXXTTXXXXTXT--XTXXXXXX-----T------T---XXXXXXX--XXXXX-------------------XXX--------------------------------T-----------------f
---X|XXXXXX|X|X|XXX----XXXX-----------|XXXX|XXXXXX|X|XXXXX|XX||XXXXXX|XXXXXXXX||XXXX|X|--X|XXXXXX-----|----o-|---XXXXXXXX-XXXXXX-----------------XXXX--------------------------------|------M----------f
m--X|XXXXXX|X|X|XXXXBBBB--------------|XXXX|XXXXXX|X|XXXXX|XX||XXXXXX|XXXXXXXX||XXXX|X|X-X|XXXXXX-----|------|-E-XXXXXXXXXXXXXXXXE--------------XXXXX--------------------------------|----------E------X
XXXX|XXXXXX|X|X|XXXXXXX----XXXXXXXXXXX|XXXX|XXXXXX|X|XXXXX|XX||XXXXXX|XXXXXXXX||XXXX|X|XXX|XXXXXX-----|------|--XXXXXXXXXXXXXXXXXXXXXXXXXXXXXXXXXXXXXXXXXXXXXXXXXXXXXXXXXXXXXXXXXXXXX|XXXXXXBXXXXXXXXXXX
