---------------------------------------------------------------------------------------------o-------------------------------------------------------------------M-----------X----------o------?-oo-----
-----------------------------------------------------------------------------------o----------------------------------M-------------------------------------------------oX----XMXXXXX---------------?---
--------------------------------------------------------------------------------------------------------------M------------------------------------------------------o-----BBBBB---------o-------BBBXXX-
------------------------------------------------------------------------------------------------------------------------------------------------------------------o-----------------------XXBXXXX----o--
-------------------------------------------------------------------------------------------------------o--------------------------------------------------o-------X------X----o----------------o?----X--
--------------------------------------------------------------------------------------------------------------------------?--------------------------------------XX???-XXX------X-------X--------o-XXX--
-------------------------------------------------------------------------M---------------------------------X----------------------------------------------------XXX---XXXXX----XX---XXXXXXXX------XXXXX-
----------------------------------------------------------------------------------------------X----------o------------------------X-------------------------XB-XXXX-?XXXXXXXXXXXXXX---XXX------X-XXXXXXv
---------------------------------------------------------------------------------------------XX--X----BMBBB--------------X-------XX---------------------------XXXXX-XXXXXXXXXXXXX----XXXX-B--XXXXXXXXXXf
---X--------------------------------------------------------------M-------------------------XXX-XX-----------------------XX-----XXX--------------------------XXXXXXXXXXXXXXXXXXXX---XXXXX-----XXXXXXXXXf
---XX----------------------------------------------------------------M---------------------XXXXXXX----------?------------XXX---XXXX-----------------------??XXXXXXXXXXXXXXXXXXXXX--XXXXXX-----XXXXXXXXXf
---XXX------------------------------------------------------------------------------------XXXXXXXX--------X--------------XXXX-XXXXX---------------------???XXXXXXXXXXXXXXXXXXXXXX-XXXXXXX----XXXXXXXXXXf
---XXXX----------------------------------------------------------------TT--------TT----T-XXXXXXTXXT-------XX?------------XXXXXXXXXX-----------------------XTXXXXTXXTXXXTTXXXXTXXTTXXXXTXX---XXXXXXTXTXXf
---XXXXX---------------------------------------------------------------||--------||-XXX|XXXXXXX|XX|-------XXX------------XXXXXXXXXX----------------------XX|XXXX|XX|XXX||XXXX|XX||XXXX|XX--XXXXXXX|X|XXf
m--XXXXXX---------------------------------------------------E-E--------||--------||----|XXXXXXX|XX|X-E----XXXX-----------XXXXXXXXXX---------------------XXX|XXXX|XX|XXX||XXXX|XX||XXXX|XXBXXXXXXXX|X|XXX
XXXXXXXXXXXXXXXXXXXXXXXXXXXXXXXXXXXXXXXXXXXXXXXXXXXXXXXXXXXXXXXXXXXXXXX||XXXXXXXX||XXXX|XXXXXXX|XX|XXXXX--XXXXX-XoXXXXXXXXXXXXXXXXXXXXXXXXXXXXXXXXXXXXXXXXX|XXXX|XX|XXX||XXXX|XX||XXXX|XXXXXXXXXXX|X|XXX
