-------------------------------------------------------------------------------------XXXX----------------------------------------?-MBBBBBBBBB-----------------------------------------------------------
---------------------------------------------------------------------------------------------------------------B-------M-------B------B----------------------------------------o------------------------
-----------------------------------------------------------------------------------o--o----------------------?o?-----------?--------M------------------------------XXXXXXXXXX---------------------------
--------M--------------------------------------------------------------------------------------------T---M----XX-T---------X-----M-BBBBBB--------------------------X------------------------------------
-----------------------------------------------------------------------------------------------------|M---T-BBX--|---------------X-?-TX-X---T----X---------------------------------------------------X--
-----T---------------------------------------------------------------X-----------o-------------T-----|----|--XXB-|-BB-----XXXXXXXXT--|T--X--|---XX--------------------------------------------------XX--
-----|---------------------------------------------------o-----------XX----X-------------------|--X--|-To-|?XXX--|-----XX-XXXX-XXX|XX||XXX--|T-XXX-------------------------------------------------XXX--
-----|X-------X------------------------------------------X-----X-----XXX---XX------XB------X---|B---o|-|--|XXXXT-|---oXXX-XXXXXXXX|-X||XXX--||XXXX----------------------T-------------------------XXXX-v
-----|--------XX-----------------------------------------------XX----XXXX--XXX----TXX-----XX--X|X----|B|--|XXXX|B|o-TXXXXoXXXXXXTX|XX||XXXX-||XXXX----------------------|-----------------------XXXXXX-f
-----|--------XXX----------------------------------------------XXX---XXXXX-XXXX---|XXX---XXX-XX|XXT--|-|-X|XXXX|-|--|XXXX-XXXXXX|X|XX||XXXXX||XXXX----------------------|-----------------------XXXXXX-f
-----|--------XXXX------o--------------------------------------XXXX--XXXXXXXXXXX--|XXXX-XXXXXXX|XX|T-|-|XX|XXXX|X|-X|XXTXTXTXXXX|X|XX||XXXXX||XXXX--X-------------------|----------------------XXXXXXX-f
-----|--------XXXXX--------------------------------------------XXXXX-XXXXXXXXXXXX-|XXXXXXXXXXXX|XX||-|T|XX|XXXX|X|XX|XX|X|X|XTXX|X|XX||XXXXX||XXXX-XX-------------------|---------------------XXXXXXXX-f
-----|--------XXXXXX-------------------------------------------XXXXXXXXXXXXXXXXXXX|TXXXXXXXXXXX|XX||X|||XX|XXXX|X|XX|XX|X|X|T|XX|X|XX||XXXXX||XXXXXXX-------------------|--------------------XXXXXXXXX-f
-----|--------XXXXXXX------------------------------------------XXXXXXXXXXTXXXXXXXX||XXXXXXXXXXX|XX||X|||XX|XXXX|X|XX|XX|X|X|||XX|X|XX||XXTXX||XXXXXXX-------------------|-------------------XXXXXXXXXX?f
m----|--------XXXXXXXX-----------------------------------------XXXXXXXXXX|XXXXXXXX||XXXXXXXXXXX|XX||X|||XX|XXXX|X|XX|XX|X|X|||XX|X|XX||XX|XX||XXXXXXX---------------E---|------------------XXXXXXXXXXX-X
XXXXX|XXXXXXXXXXXXXXXXXXXXXXXXXXXXXXXXXXXXXXXXXXXXXX-XXXXXX---XXXXXXXXXXX|XXXXXXXX||XXXXXXXXXXX|XX||X|||XX|XXXX|X|XX|XX|X|X|||XX|X|XX||XX|XX||XXXXXXXXXXXXXXXXXXXXXXXXXX|XXXXXXXXXXXXXXXXXXXXXXXXXXXXXXX
